「そっか，そっかぁ。ボク，とーさまがはじめてなんだぁ......」	「啊啊...是这样呢，我就这样把初吻献给了父亲大人...」
%CALLNAME:MASTER%はそう言って，先ほどの口づけを思い出すように，	%CALLNAME:MASTER%这样说着，就像是回味着方才的吻那般
うっとりと己の唇に指で触れた	出神地用手指爱抚着自己的嘴唇...
「ふふっ......。とーさま，ちゃんとボクがおーけー出すまで待ってくれたんだね」	「呼呼...真棒呢，直到我同意为止都没有做那种过分的事情...」
%CALLNAME:MASTER%はそう言って，%CALLNAME:MASTER%の首に手を回した	%CALLNAME:MASTER%这样说着，主动转过手来搂住了%CALLNAME:MASTER%的脖子
「ね，とーさま。もう一回してくれないかな」	「呐，爸爸，可以再亲一次吗？」
「とーさまが我慢してくれていた。実の娘との，恋人の接吻を，ね」	「毕竟呀...你也忍耐这么久了，不是吗？」
「もう，娘の初吻的を奪うとか，どういう了見なのさ！」	「真！真是的，就这样夺走女儿的初吻什么的，到底是出自什么样的想法啊...？！」
「お遊びでだったなんてオチをつけたら，真っ二つにしてやるんだから！」	「如果你告诉我只是玩玩的话，我会毫不留情地把你劈成两半的哦！」
「あれ？　どうしたの，とーさま。あらたまっちゃって」	「欸...怎么啦，爸爸，这么严肃？」
%CALLNAME:MASTER%が己の思いを告げると，%CALLNAME%は一瞬ほけっと固まり，	在%CALLNAME:MASTER%宣告了自己的想法以后，%CALLNAME%的表情便在一瞬之间凝固了
そして花がほころぶように笑みを浮かべた	紧接着，便如同花儿绽放那般露出了笑容
「いいの？　とーさま。ボク，とーさまの娘なんだよ」	「真...真的可以吗！毕竟...我可是爸爸的女儿呢」
「”せけんさま”が，怒っちゃうよ？　大変だよ？」	「这种恋情什么的肯定是不会被世人所认可的吧？」
%CALLNAME:MASTER%が自身の覚悟を口にすると，%CALLNAME%はギュッと%CALLNAME:MASTER%を抱きしめた	而在%CALLNAME:MASTER%说出自己的觉悟后，%CALLNAME%立即便是紧紧地抱住了%CALLNAME:MASTER%
「こういうときは，三つ指ついて......どうするんだっけ？　気にしなくていい？　そっか」	「如果出现这种情况的话，就用三指敬叩...然后该怎么办呢？嗯...就交给爸爸就好了吗？这样啊，明白了哦」
「えっと，末永くお願いします？　とーさま」	「嗯，那么就请永远陪着我吧？父亲大人」
当人なりに精一杯格式ばった%CALLNAME%の言葉に，%CALLNAME:MASTER%は直截的に返答した	%CALLNAME:MASTER%直截了当地回应了%CALLNAME%的话语
概ね重なり合っていた二人の影は，頭の部分においても，同様の道を辿ることになったのである	原先映照在朦胧帐上的，仅仅只是大体重叠的一对影子，此时此刻头部便也开始相向前进
「え？　あ，いや　その」	「啊...哎？那...那个...」
「とーさま，実娘に何言ってるのさ　大丈夫？」	「爸爸...你跟女儿讲这些...没关系吗？」
%CALLNAME%は胡乱な目で%CALLNAME:MASTER%を見つめている	%CALLNAME%用看傻子般的眼神瞧着%CALLNAME:MASTER%
「ん，抵抗はしないよ。でもさ，とーさま。どこまで本気なの？」	「嗯，我不会抵抗的。但是...爸爸你，真的是认真的吗？」
「......遊びだったら，喉笛食いちぎってやるんだから」	「...如果只是闹着玩的话，就狠狠地咬你的喉咙哦？」
「えっ，とーさま......？」	「啊，哎...？」
「あーっと，うん。とーさまなら，その......喜んで」	「嗯...如果是这样的话，那个...我也很高兴哦」
%CALLNAME%はそう言って，するりと帯を解いた	%CALLNAME%这样说着，轻轻地解开了腰带
「え？　物陰に入ってから？　人目？　そっか，それもそうだね」	「诶？如果不做遮挡的话就会被旁人看见...？嗯...那的确也是呢」
「いや，そのとーさま」	「欸...那个...」
「ボク，アナタの血縁だよ？　えーっと，ほら......」	「明明我是你的有血缘关系的亲生女儿哦？那个...你看...」
「いっとーしん以内ってやつだから......」	「因为会一心一意地对待...」
「え，違うの？　うーん，なら問題ないのかなぁ」	「这样吗...？嗯，那就没问题了吧」
”いっとうしん”ではなく”いちしんとう”以内だというだけの	并非是“一心一意”,而只是在所谓“一心一意”的范围以内
話なのだが。当人も納得しているらしいので良いのだろう	话是这么说着，不过本人也好像是理解着这边话里的意思吧
「ねえ，とーさま。ボク，そんなに魅力ないかな」	「呐，爸爸，说实话...我没有那么强的魅力，对吧？」
「そりゃぁ口調が女の子っぽくなかったり，服飾に詳しいわけでもないけどさ」	「除了语调不像女孩子以外，对那些服饰也不是很了解」
「もしとーさまが望むなら，そっちの方面でも努力するよ」	「但如果是父亲大人希望的话，我也会在那方面努力的」
「言葉を変えたっていい。流行りの，良く分からないもので着飾ったっていい」	「语言的方式可以改变。用流行的，不太明白的东西来装饰身体也不是不可以」
「そして勿論......勿論。とーさまが望むのなら，どれだけ淫らになったっていい......」	「当然...当然。如果父亲大人想要的话，无论把我调教得多么淫荡都可以...」
「ねえ，とーさま。血を分けた父娘の関係だからっていうのは，そんなに手を出すのに躊躇するものなの？」	「呐，爸爸，因为父女之间有血缘关系的原因，所以才会犹豫要不要插手什么的吗？」
「禁忌を犯すのが怖いなら......ボクが犯してあげる」	「如果害怕触犯禁忌的话...就由我来侵犯你吧」
「大丈夫，悪いのはとーさまじゃない。実の父親に懸想する......頭のイカレた，このボクなんだから」	「没关系哦，这样的话，不好的就不是爸爸了。而是主动拉着亲生父亲做爱的我...才是坏孩子」
「もー，とーさまのいけず！　タマなし......は，あり得ないか。ま，ともかく」	「嗯，父亲大人是个不解风情的大笨蛋...！真是的，肯定是不可能吧...」
「女の子に誘わせるなんてどういう了見してるのさ！」	「不过你啊...让女孩子主动诱惑你，到底是怎么想的！」
「色々ゆーわくしてもちっとも反応してくれないし」	「即使做了很多事情，也一点反应都没有」
「いーよ，それなら。直接ボクがやっちゃうから！」	「既然那样的话，就干脆直接由我来做好了！」
押し倒した%CALLNAME:MASTER%に馬乗りになった%CALLNAME%は，そう言って自らの着衣を肌蹴ていく	主动骑在被压倒在床的%CALLNAME:MASTER%身上%CALLNAME%，一边这样说着，一边迅速将身上的衣物扔向旁边
不貞腐れて頬を膨らませてはいるものの，こちらの視線を意識した僅かな素肌の見せよう	突破界限的羞耻感使得%CALLNAME%的脸色染得通红，同时也主动撩起衣服展示着暴露的肌肤以试图吸引%CALLNAME:MASTER%的注意力
或いは未成熟な肢体を%CALLNAME:MASTER%に擦り付けてくる様から	同时未熟的身体也紧紧贴在%CALLNAME:MASTER%身上，不住地磨蹭着
%CALLNAME%が相応の計算を持って%CALLNAME:MASTER%の情欲を掻きたてようとしているのが分かる	很显然，%CALLNAME%想要勾起%CALLNAME:MASTER%的情欲的行动，完全是出于本人的意愿...
「ほんとに，もう。ボクじゃとーさまのお眼鏡に適わないのかなって，不安になるじゃない......」	「真的...现在的我，已经完全不在乎自己能否入得了父亲的眼了...」
「ふーふふふ。ぼーくーはー，酔っ払いなのらー♪」	「呼呼...是啊，喝醉~了呢♥」
紅潮した頬，呂律の回らない台詞とは裏腹に，%CALLNAME:MASTER%の服を脱がすその手つきは的確で	与那红潮染遍的脸颊与口齿不清的表象相反，%CALLNAME%脱下%CALLNAME:MASTER%衣服的动作无比轻快...
その瞳には，情欲の火の影から計算高いなにがしかの光が見受けられる	在那双情欲之火燃烧着的眼中，可以看出这小家伙全然是蓄谋已久...
「とーさま，その......」	「父亲大人，那个......」
%CALLNAME%は上目づかいで%CALLNAME:MASTER%を見上げ，その袖を引いた	%CALLNAME%抬头仰望着%CALLNAME:MASTER%，随后便将手伸向这边，抓着袖口轻轻拉了拉
「ふふ......。とーさま♪」	「呼呼...父亲大人♪」
「酔った勢いだし，せーじょーな判断なんかできないし。ボクいつもより積極的になれると思うんだ」	「因为人家喝醉了~所以说呀...无法控制自己的行为什么的，会主动做出这种事情也是很正常的对吧~？」
酒精だけの影響とはとても思えぬ艶を含んだ仕草でもって，%CALLNAME%は%CALLNAME:MASTER%へと未成熟な肢体を擦り付ける	%CALLNAME%以全然不似喝醉的色情动作主动在%CALLNAME:MASTER%摩擦着自己那未熟的身体
「ね，とーさま。酔った娘を襲うシチュエーションっていうのも，いいと思わない？」	「呐~爸爸，就这样侵犯喝醉的女儿什么的...不觉得这样很色情吗？」
「う～。ピンク色のゾウが，窓に，窓にぃ......」	「嗯~粉红色的大象，在窗户上爬着，怎么办，眼睛要跟不上了...」
「とーさま，ここまで醉酒つぶすのは......どうかと......ばたん」	「爸爸，都已经醉到这种程度了...怎么办...要变成笨蛋了...」
どうにもまだ余裕があるような気もするが	总觉得她似乎还很有余裕的样子....
%CALLNAME%の様子を見るに，今夜はもうお開きにした方が良いようだ......	不过至少从%CALLNAME%目前的状态上来看，今晚果然还是好好地锁门要比较好...
「ふふっ......そっかぁ。ボクのお腹に，とーさまの子が......」	「呵呵...是这样呢，在我的肚子里，孕育着和父亲大人共同生下的孩子...」
「ねえ，とーさま。この子のことはどうするの？」	「呐，爸爸。这孩子的事，该怎么办呢？」
「堕胎とか，そんな話じゃないよ。とーさまがそんなこと望まないのは分かってるよ」	「不是要说堕胎之类的话。我知道爸爸你也不喜欢这样」
「ボクが聞きたいのは，さ......」	「我想问的是...」
そう言って%CALLNAME%は老若男女問わずにぞくりとさせるほどの凄絶な色気をもって，	%CALLNAME%的浑身都好像散发着某种男女老少都无法抗拒的色气
薄く膜がかかったかのような，光の見えない瞳で%CALLNAME:MASTER%をを見上げ，言葉を続ける	———紧接着，她便抬起头来，用那仿佛是被一层薄膜所覆盖着的，从里面看不见半点光亮的眼睛仰望着%CALLNAME:MASTER%，随后便是再度开口
「......この子のことも，ボクみたいにちょーきょーするの？　とーさまのものに，しちゃうの？」	「...这个孩子也会变得像我一样吗？你会怎么对待她呢？」
そうだったら楽しみだなぁ。きっとこの子も幸せだよ	那样的话，就会更加期待了啊...这个孩子一定也会因此而感到幸福的吧
%CALLNAME:MASTER%の返事を待たずそう続けた%CALLNAME%は，慈母の笑みとはまさにこれなりといった風情で微笑み，	%CALLNAME%不等到%CALLNAME:MASTER%回复，只是继续说着
愛おしそうに己の腹を撫でている......	爱抚着自己的肚子的同时，悄然间在她的唇上，也似乎挂上了一抹属于母亲的浅淡微笑
「次はちゃんと，とーさまの娘を孕ませてほしいな」	「下次...希望能够好好地生下父亲大人的女儿呢」
「そりゃ，妖術の手管を深めたいって言うとーさまの思惑も分かるけどさ」	「当然，如果父亲大人说这只是练习妖术的某种手段，我也能理解这种想法就是了」
「娘の子袋使って，これは無いんじゃないかな」	「把女儿的身体作为肉袋来使用...这种事情也不是没有嘛」
「頭のネジが外れた娘に見えるのは分かるけどさ」	「虽然我知道，现在的我作为女儿，看起来简直就像个脑袋里少了根筋一样」
「......ボクだって，女の子だよ？　孕むなら，ヘンなものより，ちゃんとした娘を宿したいよ」	「不过至少，我也是女孩子啊？怀孕的话，比起奇怪的东西，我更想有个正常的女儿呢...」
「ん......ごめん，とーさま。暫くは戦えないっぽい」	「嗯...对不起，爸爸。我好像...暂时不能战斗了」
「でもでも，でもさ。ボクとこの子を，守ってくれるよね？」	「但是，爸爸肯定会保护我和这个孩子的吧？」
「とーさまの子と，そのとーさまととーさまの子の子を，さ」	「父亲大人的女儿，还有父亲大人和父亲大人的女儿所共同生下的孩子」
「あっ，とーさま　見て見て。とーさまと，ボクの子だよ」	「啊...父亲大人，快看。这是...父亲大人和我所共同生下的孩子哦？」
「うん，そうだよ。とーさまの，次のちょーきょー相手」	「嗯，是啊，父亲大人的下一位床伴」
「生まれた時，ううん。生まれる前からとーさまのモノになるって決まっている」	「出生的时候，不。从出生前就决定要成为父亲大人的所有物的孩子」
「淫らでイカれた，とーさまのオモチャ」	「属于父亲的，最疯狂的性玩具...」
「ふふっ......。この子は，どんな風に乱れるのかな」	「呵呵...这孩子到时候，会淫乱成什么样子呢？」
「言葉を覚えるより先にせーえきの味を覚え」	「在记住语言之前，先记住的是父亲大人的味道」
「じょーしきより先にとーさまへの奉仕を覚えて」	「在学会爬行之前，先学会的是侍奉肉棒...」
「どんな風に，とーさま専用になっていくのかな......」	「到底会变成怎样，成为父亲大人专用的玩具呢...」
楽しみだなぁ，この子も喜んでくれるといいなぁ......	好期待啊，要是这个孩子也会因此而高兴就好了...
狂った人生プランを呟きつつ，慈母そのものの表情で，%CALLNAME%は我が子をあやしている	%CALLNAME%一边嘟囔着疯狂的人生计划，一边带着慈母本身的表情，轻声哄着自己的孩子
「ふふっ，かぁいいなぁ。ボクの娘，ボクの妹，とーさまのオモチャ」	「呼呼...真好啊。我的女儿和妹妹，还有...父亲大人的玩具」
「ね，とーさま。見て，この手」	「呐，父亲大人。看看她的手吧」
「この細くて千切れそうで，でもちゃんと動くこの不可思議が」	「纤细幼小且脆弱，但是却不可思议地具有着完整的行动能力」
「とーさまのおちんちんを握って，愛撫するんだ」	「就这样握住父亲大人的肉棒，爱抚着它...很合适吧？」
「みてみて，この歯の生えそろってない口」	「然后再看，这颗牙都尚未长齐的小嘴」
「この口がとーさまのものを愛撫するんだ」	「也可以像我的嘴巴一样，对父亲大人的肉棒提供爱抚，或者是口交」
「美味しそうに，とーさまのせーえきを飲むんだ」	「看起来很美味呢，毕竟啊...她是吃着父亲大人的精液长大的哦？」
「勿論，胸だって，お尻だって，そしてそして，あそこだって」	「除此以外...胸部，屁股，还有小穴...」
「ぜんぶぜんぶ，とーさまのもの。とーさまが気持ちよくなるためのもの」	「她全身上下，都是属于父亲大人的东西哦？为了让父亲大人舒服起来而存在的东西」
「ふふふ，この娘は幸せ者だよ。だって生まれた時から」	「呼呼...这个女儿，真是幸福呢，因为她从出生开始...」
「その全てでとーさまのものになれて」	「活着的意义，就只有侍奉父亲大人这一项」
「おかーさんでおねーさんなボクが，そのためのすべてを」	「当然呢，作为母亲与姐姐的我，为了让她能够更早的对父亲大人有用...」
「ちゃぁんと，教えてあげるんだから」	「也会好好地教育她的呢」
「え？　とーさまの陣営に来いって？」	「诶？来父亲大人这边的阵营？」
「あ，うん。いーよ」	「啊，当然可以啊」
「よろしくね，とーさま♪」	「那么，以后也请多关照，父亲大人♪」
「......ごめん　いくらとーさまの頼みでも，それはダメ」	「...对不起，即使是父亲大人的请求，那也不行」
「だって，さ」	「因...因为」
「とーさまの娘が，とーさまに命じられたら」	「自己是父亲大人的女儿，然后只是被父亲大人命令的话」
「あっさり主君を裏切る尻軽だなんて事態」	「就这样干脆地背叛了主人」
「絶対，とーさまの損になるもの」	「绝对，会给父亲大人带来名声上的损失的吧」
「ふつーこういう感覚って，肉親以外に抱くものだと思うんだけどなぁ」	「这种感觉...肯定不是血亲之间所应该抱有的吧...」
「とーさまのことを想っただけで，こんなに......」	「仅仅只是想着父亲大人，就这么...」
「じかふわごーせーはどこに行ったんだか」	「啊...又去工作了吗？嗯...」
「あー，もうっ！」	「真是的...！」
思い人を想起して頬を赤らめる%CALLNAME%	%CALLNAME%因思念着心上的人而在床上翻来覆去打着滚
とはいえ，幼い心はそれをきちんと受け止められていないらしく	显然，这份感情并没有被她幼小的心灵好好地接
%CALLNAME%はそのまま寝台に倒れ込み，火照った顔を隠すように枕に顔を埋めた	接着，%CALLNAME%也就这样倒在床上，把脸埋在枕头里，仿佛这样就可减轻些许的羞耻感般
「あぁ，うん。なんだか取り返しのつかないところまで来ちゃったみたいだなぁ」	「啊，嗯...总觉得到了无法挽回的地步了啊...」
寝台の上，一人枕を抱きしめた%CALLNAME%はぽつりとそう呟く	在卧铺上，一个人抱着枕头的%CALLNAME%轻声地呢喃着
「ボクのとーさまへのそれって，普通のれんあいかんじょーじゃないみたい」	「对我父亲大人的感情，恐怕早就已经超出正常的血亲了吧」
「とーさまのものになりたい。とーさまに全部あげたい」	「我想要成为父亲大人的所有物，将所有的一切全部都献给他...」
「とーさまが気に入るように，とーさまの都合がいいように，ボクを変えて行って欲しい」	「为了让父亲大人喜欢，也希望他能够随意地改变我的身体...」
「ボクの今も，未来も。......たぶん，その先も。全部あげちゃいたい」	「无论是我的现在还是未来，还有更多更多...全部都想要为父亲大人献上」
「絶対ヘンだよね。こんなの，おかしいよね」	「这种感情...绝对会显得很奇怪吧」
「とーさま，ボクがこんなこと望んでるって知って，引かないかな」	「如果父亲大人知道了我想要这种事情的话...会不会退缩呢？」
「頭のおかしい近親相姦願望まみれの娘だからって，キライになったりしないかな」	「即使是作为血亲的女儿...如果满脑子都是那些奇奇怪怪的乱伦的话，也会变得讨厌吧」
「だ，大丈夫だよね？　とーさまだって実娘に手ぇ出すヘンタイ外道なんだし，大丈夫だよね？」	「不过...明明父亲大人也是会对亲生女儿出手的外道，肯定...也是没关系的吧？」
自らの想像に怖くなってきたのか，%CALLNAME%は目じりに僅かに涙を浮かべ，	也许是因为在害怕自己的想象吧，%CALLNAME%的眼角稍微溅出了些许的眼泪
不安げにぎゅっと枕を抱き直す	同时，也不安地紧紧抱住了身旁的枕头
言っていることこそ狂ってはいるものの	虽然她说的话的确疯狂过度
その姿は，恋人を想って煩悶とする，恋する少女そのものだった	但此时那正颤抖着的身姿，正是思念着恋人的少女的形象本身...
血のつながった父娘での交歓	血脉相连的父女，彼此之间的交欢
膣で，胸で，手で，指で，尻穴で，	无论是膣穴，双乳，手掌，手指，还是屁穴
或いは肌でさえも	或者，甚至是皮肤，与身体的里侧
%CALLNAME:MASTER%によって	由于%CALLNAME:MASTER%在%CALLNAME%的身体各处所刻写下的
あらゆる場所で与え，与えられた悦楽は	深刻的快感与喜悦
%CALLNAME%を取り返しの付かぬところまで深く歪めていた	%CALLNAME%的理智，已然是被深深地扭曲到了无可挽回的境地
「とーさま。ボク，もう我慢できないよ」	「父亲大人，我已经无法忍受了」
そう言って%CALLNAME%は，%CALLNAME:MASTER%の情欲を掻きたてるように	%CALLNAME%这样说着，仿佛是在勾起%CALLNAME:MASTER%的情欲那般
%CALLNAME:MASTER%の目の前で，ゆっくりとショーツを降ろしていく	主动在%CALLNAME:MASTER%的面前，缓缓地将亵裤从腿上褪去
愛撫を一切施されていないにも関わらず，	尽管没有施行任何爱抚
既に秘所は濡れに濡れているのだろう	秘处也依然被彻底濡湿
繊細な刺繍の施された真白いショーツは愛液で湿り	绣有纤细刺绣的雪白亵裤，被爱液彻底潮湿
白濁した愛液が糸を引きながら，性器と下着の間に淫靡な橋をかけている	伴随着逐渐将亵裤移开的动作，膣口与布料间也逐渐架起一道淫靡的桥梁
「ねぇ，頂戴。とーさまのガチガチでおっきいの」	「呐，现在...就请把父亲大人的肉棒，好好地给我吧~」
「とーさま自身のそれで作ったボクの膣内に入れて欲しいな♪」	「希望能把这根肉棒好好地插进由它所创造的，人家的小穴里喔♪」
情欲に双眸を濡らし，幼いかんばせを淫らにほころばせ	炽热的情欲濡湿少女的双眸，使得这朵幼小的娇花淫乱地绽放着
%CALLNAME:MASTER%の眷属はＶ字に開いた指で秘貝を広げて見せる	%CALLNAME:MASTER%的血亲，主动用V字张开的手指撑开了两侧的肉瓣
己を創り，己を淫らに染めきった主の物を突き込んでほしい	就这般将创造自己，接着又将自己染上淫乱颜色的肉棒容纳其中
%CALLNAME:MASTER%の娘に，より深い淫悦を刻み込んでほしいと	紧接着，又因渴望着%CALLNAME:MASTER%能够为女儿刻下更加深刻的快乐的记忆
病みきった懇請を口にする	而张开口，发出着病态的恳求
ただそれだけならば	也正因如此
ただ，それだけならば	正因如此
特段驚くにはあたらない出来事だっただろう	下一幕的事件无可避免的发生了
%CALLNAME:MASTER%は言い逃れなどできようはずもないほど	%CALLNAME:MASTER%无法蒙混过关，也毫无如此去做的必要
深く%CALLNAME%を調教していたし	就这般深刻地调教着%CALLNAME%的身体
%CALLNAME:MASTER%の娘自身，喜んでそれに応じていたのだ	而身为女儿的%CALLNAME%自己，也很高兴地答应了
%CALLNAME%が明快極まる振る舞いと共に近親相姦願望を吐露したとしても	在%CALLNAME%做出的简单明快的行为，以及由她本人向着自己父亲吐露过乱伦愿望的那一日后
例えばそれが閨での出来事，	无论是曾经在闺房中所发生过的事情
或いは%CALLNAME:MASTER%の寝室での出来事であれば	还是在%CALLNAME:MASTER%寝室里曾发生国的事情
それはもはやただの日常である	都已经只是日常生活的一部分了
%CALLNAME:MASTER%と%CALLNAME%との間では，	在%CALLNAME:MASTER%和%CALLNAME%之间，至少在性方面—————
特筆すべきことのない，ありきたりの出来事である	几乎也已经再无什么特别值得一提的，特别的事情了
とはいえ，そこまでである	话虽如此
いかな狂った父娘であっても，	但这对疯狂的父女
彼らなりの倫理観の下，時と場合は選んでいる	他们时常也会根据着自己扭曲的伦理观，选择行淫时间和场合
例え吃飯処で口淫にふけり	譬如在饮食店或是食堂中，沉溺于口淫之中
或いは野外で事に及ぶことがあろうとも	亦或者是野外露出的性交
明白に常人未満の良心の下ではあるものの	明明此时二人的良心都已然退化到常人未满的境地
二人は曲りにも何も節度を忘れ去ってはいないのだ	他们也仍未忘记名为分寸的东西
しかしそれも今までのこと	但那，也是至今为止的事情
%CALLNAME:MASTER%の与えた悦楽は余りに深く，重く	由于%CALLNAME:MASTER%所给予的喜悦实在是太过沉重
%CALLNAME%の無垢で奔放な魂を枷から解き放つには十分に過ぎた	以至于将%CALLNAME%纯洁奔放的灵魂从世俗伦理的枷锁中中解放出来以后
今や%CALLNAME:MASTER%の娘の心は淫悦に染まり切り	又在那快乐的记忆刻写在其心灵之上，将其彻底染上淫悦的颜色
大よそヒトの倫理観からはかけ離れたものへと成り下がっていたのである	此时此刻，他们的伦理观，已然是与人类普遍的伦理观相去甚远了...
「敵兵切ってたら，さ」	「即使是殒身在我手下的那些敌方士兵们」
「こいつらにも家族がいて，異性の血族がいて」	「他们也有着自己的家人，以及子女」
「多分その人たちに愛情注いで，注がれて」	「他们，大多数也都会将爱倾注到自己的家庭中」
「ボクはそんな背景情報が詰まりに詰まった血袋を引き裂いて」	「而在战场之上，我却亲手将身为社会信息的总和的他们的脖颈撕裂了...」
「数えきれないし，分かっちゃいけないだけの悲しみを量産しているんだっておもって，さ」	「于是，我就会感觉...自己就这样制造了属之不尽的悲伤，好残忍，什么的...」
「そしたらなんか，我慢できなくなっちゃった」	「然后啊，就总觉得无法忍受了」
普段通りににへらと笑う%CALLNAME%の全身は，返り血に染まっている	像往常一样笑着的%CALLNAME%的全身，此时此刻都被鲜血所染透
腰にくくりつけられているのは，敵武将の首であろう	挂在腰上的，正是敌方武将的首级
てんでバラバラの方向を睨み付けているそれらは，	即使只是看着那死前英武的仪容
一様に生前の器量の良さが分かるものだ	都能看出她们生前的优秀与强大
人脂を巻き，使い物にならなくなったのか	然而此时此刻，却也只是被斩下头颅的冰冷尸体罢了
傍らに立てかけられた得物は，いつも使っているそれとは別のものである	在周边所存在着事物，也与正常生活中的截然不同
そう，ここは戦場だ	没错———这里是战场
既に戦は終わったとはいえ，先ほどまで命のやり取りが行われ	虽说这场局部的战役已经结束了，但双方对彼此阵营生命的收割一直持续到现在
%CALLNAME:MASTER%も，%CALLNAME:MASTER%の娘もその渦中にあり	而%CALLNAME:MASTER%和%CALLNAME:MASTER%的女儿———也正是在这片漩涡之中
狂騒が終わった今となっては彼我双方の被害の確認，	到了混战结束的如今，在确认了彼此双方的损失后
陰鬱な戦場の”掃除”と”道具の回収”など	就是在阴郁的战场的“打扫战场”与"道具回收"的环节
粛々と進めるべき行事が山積みとなった	应当严肃进行的活动堆积如山
大よそ情事とはかけ離れた，鎮魂の場である	很显然，这是一片决然不当与情事扯上联系的镇魂之所
しかし%CALLNAME%は%CALLNAME:MASTER%の天幕の入り口に立ち	此时此刻，%CALLNAME%正站在%CALLNAME:MASTER%的帐篷入口
血と汗と死に塗れた姿のまま	展示着自己那沾满鲜血与汗水，浑身都包裹着死亡气息的身体
情欲に塗れきった有様を晒し%CALLNAME:MASTER%の慈悲を乞うてくる	困于情欲中的模样，乞求着%CALLNAME:MASTER%的慈悲
「とーさま。きて」	「来吧，父亲大人」
「ボクをじゅーりんして」	「紧紧地拥抱我吧」
「ボクがなんで生きているのか，なんで一杯殺したのか」	「我为什么还活着，而不是地上那些冰冷尸体的一员呢？」
「ボクがとーさまのモノで，とーさまの為に生きているんだって」	「因为我是只为父亲大人而活着的，属于父亲大人的所有物...嘿嘿，是这样吗~」
「とーさまのおちんちんで教えこんで欲しいな♪」	「呐~就这样夸夸我吧，这样的话...这种认知也会在我的脑海里更加巩固的哦？♪」
%CALLNAME:MASTER%の情欲を掻きたてるように	像是勾引般的语句，激发着%CALLNAME:MASTER%的情欲
%CALLNAME%が地面に膝を付き，くるりと後ろを向く	%CALLNAME%就这般跪伏在地，主动将身体向后抬起
未発達で小振りなまま，%CALLNAME:MASTER%によって開花された	尚且未熟的幼小花朵，就这般淫乱地开放着
痛々しいまでに淫靡な臀部が%CALLNAME:MASTER%に掲げられ	稚女淫靡的娇臀就这般被%CALLNAME:MASTER%强行地抬起
その拍子に娘の腰に付けられていた首級がごとりと落ちる	而就在这时，挂在女儿腰上的首级，就扑通一声掉了下来
乾きつつある赤黒い血のこびりついた，無念の表情の武将の首	表情已然变得无神的武将脖颈上方，正在变干的红黑色血迹就这般粘连在一起
地面に転がるそれを欠片も気にせず，	即使是硌着地上的碎片，已死的头颅也无法对此表达不满
%CALLNAME:MASTER%の血を半分引き，%CALLNAME:MASTER%自身によって	身为%CALLNAME:MASTER%女儿的%CALLNAME%，就这般与%CALLNAME:MASTER%本人亲密地紧贴着
調教されつくし，%CALLNAME:MASTER%の子を，	被刻写下深刻的调教记忆的%CALLNAME:MASTER%的女儿
己の妹を身ごもることを渇望する%CALLNAME%	渴望怀上自己妹妹的%CALLNAME%...就这般淫靡地绽放着
地に転がる死	滚落于地的，是为死者之颅
掲げられる生	响彻于空的，即乃生者之歌
%CALLNAME:MASTER%によって引き起こされた狂った性と死が	萧瑟的寒风，就好似引渡冤魂们前往三途川的信号
%CALLNAME:MASTER%を誘惑する	而此时此刻，暧昧亲近着的二人，也与此刻这肃杀的背景，形成了无比巨大的反差
「ひっ，あぁっ！　......と，とーさま」	「嗯...啊...父，父亲大人~~」
「な，なんかいつもより荒っぽくない？　いや，それはそれでって......ひゃぅぅぅぅっ！」	「啊...总觉得比平时更粗暴...呜，明...明白了...呜啊啊~~~~！」
武将用の豪奢な天幕。その重厚な絨毯の上に，荒々しく引き倒される%CALLNAME%	方才回到营帐时，%CALLNAME%便被其父狠狠推倒在了前方的厚重地毯上
付き込まれる%CALLNAME:MASTER%の怒張の熱さと逞しさに	膣穴紧紧缠绕着%CALLNAME:MASTER%那炽热的怒张
%CALLNAME:MASTER%のものを受け入れるためだけに	将%CALLNAME:MASTER%那根粗大的硬物紧紧地缠绕着
開発された膣内を抉るその激しさに	而紧接着，这根肉棒便开始从各个角度粗暴地顶撞起来
%CALLNAME%は悲鳴とも嬌声ともつかぬ声を上げる	激得%CALLNAME%不住发出着不知是娇声亦或者是尖叫的淫靡声音
「はぅっ，や，んっ......ひぅっぅ！」	「呜...啊...嗯唔...」
「とーさま，とーさまぁ......」	「父亲大人，父亲大人...！」
内臓どころか魂魄にまで陰茎の形を刻み込もうとするかのような	岂止是内脏，只怕是连魂魄都要强行刻写上阴茎的形状
%CALLNAME:MASTER%の抽挿	%CALLNAME:MASTER%的抽插的动作
もとより　より深く，より取り返しの付かぬ場所まで	狠狠顶撞着%CALLNAME%比原来要更深，更加无可挽回的地方
%CALLNAME:MASTER%のモノになることを望む少女は，	而渴望成为%CALLNAME:MASTER%所有物的少女
喜びと共に実父の凌辱を受け入れる	也自然是，在喜悦的同时，欢欣地接受着来自亲生父亲的淫辱
「とーさま，きて，きて......」	「来吧...父亲大人」
「ボクはいつだって，どこでだって，とーさまの道具だよ」	「无论何时何地...我都是父亲大人最忠诚的玩具」
「閨でも，日常でも，戦場でだって」	「无论是在闺房，日常生活还是战场」
「とーさまの望む娘であり，官吏であり，武将であり」	「作为女儿，官员，亦或者是武将」
「そしてエッチな人形なんだ」	「我最重要的身份，依旧是父亲大人的性爱人偶」
「ねぇ，ねぇ，とーさま」	「呐，呐...父亲大人」
「ボクはとーさまのものだよね？」	「我是你的东西吧？」
「ボクはとーさまのもの足りえているんだよね？」	「我已经有了作为父亲大人的所有物的资格了吧？」
狂気の献身を捧げながら，どこまでも心細げに	在疯狂地献身的同时，%CALLNAME%的内心深处，却是无限的焦虑
暗闇の中の幼い迷子のごとく，%CALLNAME%は%CALLNAME:MASTER%を見上げる	%CALLNAME%就宛如黑暗中迷路的年幼孩子那般，仰望着%CALLNAME:MASTER%，并时刻畏惧着父亲的离去
或いは，%CALLNAME%の恐れは	也许，%CALLNAME%的恐惧
%CALLNAME:MASTER%のもの足りえないかもしれないという不安は	就是因为对%CALLNAME:MASTER%的贪欲过强方才会产生
永遠に解消されないのかもしれない	而正因为这可怕的原因，所以...或许是永远都不会消失的东西
しかし%CALLNAME%の献身が，或いはそれとは異なる正気を欠いた妄念が	而在此之下%CALLNAME%的献身———以及，与之不同的其他毫无正气的疯狂妄想
今までのそれよりもなお深い闇を孕んだのは間違いないだろう	想必是，孕育了比至今为止还要更加深邃千倍万倍的黑暗吧
%CALLNAME:MASTER%の実娘の淫らがましさは，常軌を逸したものだ	%CALLNAME:MASTER%的亲生女儿的淫荡，是越出常轨的
死に満ち，生者が死者に仕える場所でさえなお	即使是充满死亡的，生者侍奉死者的地方
%CALLNAME%は淫猥に，%CALLNAME:MASTER%の慈悲を求めるだろう	%CALLNAME%也会在淫猥中，寻求%CALLNAME:MASTER%的慈悲
肉の交歓と，その先にある	除却纯粹肉欲的交欢以外
%CALLNAME:MASTER%の性玩具を孕む幸せを望むだろう	%CALLNAME%也因自己对于孕育%CALLNAME:MASTER%的性玩具的渴望，而幸福着
%CALLNAME:MASTER%の調教は順調で，一つの区切りにまでたどり着いた	%CALLNAME:MASTER%的调教，此时此刻已然是到达了最终的境地
%CALLNAME%は淫欲に狂い，常に%CALLNAME:MASTER%に蹂躙されることを待ち望んでいる	%CALLNAME%已然彻底痴迷于淫欲，终日盼望着被%CALLNAME:MASTER%所蹂躏
例えその場が日常のそれであろうとも，非日常の極限たる戦場であろうとも同じことである	不管是在日常生活中，还是非日常的极限战场里，皆是如此
%CALLNAME:MASTER%の実娘たる%CALLNAME%は	此时此刻，作为%CALLNAME:MASTER%的亲生女儿的%CALLNAME%
今や%CALLNAME:MASTER%に与えられる淫欲の虜であるのだ	已然彻底堕落为沉沦于%CALLNAME:MASTER%所赐予的淫欲的俘虏...
「え，ケッコン？　ボクが，とーさまと？」	「欸...结婚...？我和父亲大人？」
「なに？　ぱんぱかぱーんって，レベルキャップ解放したいの？　155まで」	「什...邦邦☆咔☆邦♪ 然后就要把人家的等级上限解放到155级了吗？」（译者语：等级解放的梗出自舰C，婚舰的等级上限会被解放至155，至于这个口癖好像从舰C的爱宕到碧蓝档案的爱丽丝都有的样子）
色々と危ない妄言を口走る愛娘に，巻物を放る	就这般对着说出奇怪话语的爱女，摊开了卷轴
んもう，なにさとぼやきながらもそれに目を走らせる%CALLNAME%	原先还在发着牢骚的%CALLNAME%，见到其上方的内容以后
幼子の目に，驚きと歓喜が宿る	她的眼底，便在转瞬间，被惊讶与喜悦所填满
「え？　ほんとにやらかしたの？」	「诶？真的这么做了吗？」
「ほんとに，ボクのために？」	「真的，只是为了我...？」
%CALLNAME%が驚くのも当然の帰結であった	%CALLNAME%的惊讶，也自然是理所当然的结果
巻物には%CALLNAME:MASTER%が所属する勢力において	卷轴的内容，大致如下
一つの法律が改正されたことが記されていたからだ	就在%CALLNAME:MASTER%所属的势力中，一条法律被修改了
即ち，近親者との婚姻を禁止する条文が，ものの見事に削除されたのである	也就是说，禁止与近亲结婚的条文被巧妙地删除了
無論，何もせずにそんな結果が得られるわけもない	当然，也不可能什么都不做，就得到那样的结果
%CALLNAME:MASTER%が後ろ暗かったり，血腥かったり，	这都是%CALLNAME:MASTER%长久以来
山吹色のお菓子が乱舞する暗躍を続けた結果である	在暗中以贿赂，暗杀等黑暗的方式，持续运作推动的结果。
ここ最近，何人かの大物が首をくくったり，隠居したり	最近，有几个大人物上吊自杀，又或者是辞官隐居
ショドー中に転倒死したりして表舞台から消えていたのは	亦或者是在明面上假死以脱身到暗处等
別段偶然の産物ではなかったのだ	都不是偶然的产物
最早%CALLNAME:MASTER%が%CALLNAME%を娶ることを阻む法的な障害は存在しない	此时此刻，已然不再存在阻止%CALLNAME:MASTER%与%CALLNAME%结婚的法律障碍
......無論，道徳的，倫理的問題は厳然として存在しているはずだが	...不过至少，道德上的，伦理的问题依旧存在着
%CALLNAME:MASTER%が伝える，極めて素っ気のない求婚の言葉―――――	在%CALLNAME:MASTER%以极其冷淡的语气发出求婚的言语时——————
気氛も何もなく差し出された指輪を前に，%CALLNAME%は笑う	%CALLNAME%面对着眼前毫无气氛地递上的戒指，不禁是露出了浅淡的笑
「そっか。とーさまは，まだ心配なんだね」	「我明白啦，父亲大人还在担心呢」
「実の娘に懸想させ」	「担心于对自己亲生女儿的占有欲呀...」
「心も体も魂も，何もかも捧げたいとまで傾倒させ」	「在这之前，就先将我的思想改变到能够为父亲大人您从身到心都彻底奉献而出的境地...」
「その辺の娼婦なんて及びもつかないくらい，淫らでエッチな女の子にして」	「再把我的身体调教成就连周边的妓女也比不上的那种淫荡色情的样子...」
「それでもまだ，ボクがとーさまのものになったのか不安なんだね」	「不过即使如此，也还是对于我是否已经彻底成为父亲大人的所有物...有所不安呢，对吧」
「いーよ，とーさま」	「呐，爸爸」
「ボクを，とーさまのお嫁さんにして」	「就这样，让我成为你的妻子吧」
「天下万民に，ボクがとーさまのものなんだって，明白にして」	「让天下万民都明白，我是你的」
愛おしげに%CALLNAME:MASTER%の胸に顔を埋める%CALLNAME%	%CALLNAME%包含爱意地轻声说着，同时也将脸埋在了%CALLNAME:MASTER%的胸口
その，内包する力とは裏腹に触れれば折れそうな細い手を取り	随后，%CALLNAME:MASTER%也就握上了她那外表与内里所蕴藏着的力量截然相反的，纤细柔软的手腕
左手の薬指に指輪を通す	把戒指戴在了她左手的无名指上...
「とーさま，だいすき，だいすき」	「父亲大人，最喜欢你了哟」
「ずっとずっと，死ぬまで。ううん」	「一直一直，直到死为止...不」
「地獄でも，生まれ変わっても」	「即使是依然沦落到地狱，又或者是身死战场而抵达来生」
「ボクを永遠に，鎖に繋いで」	「我的灵魂也依旧永远都在锁链之上」
「とーさまのモノでいさせて......」	「作为父亲大人的所有物而存在着...」
背伸びして口づけを求める%CALLNAME%と	主动探来身子寻求着接吻的%CALLNAME%
%CALLNAME:MASTER%の影が重なり合う	与%CALLNAME:MASTER%的影子重叠在一起
舌を絡ませ合う，普段の淫靡なそれではない	互相缠绕着彼此的舌，但动作却并不像平日里的淫靡那般
しかし親愛の情を示すそれとはまったく重みの違う	但却也与普遍表达亲爱之情的做法完全不同
誓約の儀にも似た接吻が交わされる	就这般持续进行着誓约仪式过后的接吻环节...
無数の問題と抗議が乱れ飛び，	无数的问题和抗议乱飞
%CALLNAME:MASTER%の所属する勢力の文官が悲鳴と怨嗟の声を上げる	%CALLNAME:MASTER%所属势力的文官也发出了悲鸣和怨叹的声音
倫理的に外れきった婚儀が行われるのは	举办这场不合伦理的婚礼什么的
この数日後のことであった―――――	也已经是几天后的事了——————
「んっ......あっ......とーさま，とーさまぁ......」	「嗯...啊...父亲大人，父亲大人...♥♥」
薄暗い寝所の中，一人寝台に伏せる%CALLNAME%	在昏暗的卧室里，%CALLNAME%正独身一人趴伏在床上
俯せになった少女は，まるで挿入を求めるかのように尻を掲げ濡れそぼった秘所を夜気に晒し	低着头的少女，仿佛是在寻求插入似的，在夜色中翘起屁股，暴露出被淋湿的秘处
解れきり，男根に蹂躙されることを待ち望むかのようなそこを指でかき乱している	仿佛在渴望着被男根蹂躏使得，用手指肆意地拨弄着那里
「あ，はっ......う，んっ......そう，そうだよ」	「啊，哈...嗯，嗯...啊啊...♥」
「もっと乱暴に，ボクのナカをじゅーりんして」	「更加粗暴地，多插进来一点...」
「おくのおくまで，とーさまの......ものに......んんっ......っ！」	「就这样，插到人家的最里面，父亲大人的...肉棒...嗯...啊啊~~~！」
%CALLNAME%の想像の中で，%CALLNAME:MASTER%はどのように実娘を犯しているのであろうか	在%CALLNAME%的想象中，她的父亲是如何侵犯着作为亲生女儿的自己的呢
空虚な目で虚空を見つめ，	如果只是看着她的脸的话，从那凝视着虚空的空虚眼睛
白雉にも似た淫猥な笑みを浮かべる%CALLNAME%の様から	与唇角所挂着的淫靡笑容中
その詳細を窺い知ることはできない	自然是不能窥见其详情
しかし太ももどころか踝にまで伝う淫液	但是，若将视线稍稍下移，稍微望向她的胸前，便会从那凌乱的衣间看见
乱れ肌蹴た夜着から覗く，紅潮した白い肌から	内里那本来白皙的肌肤，此刻都泛起了大片的红潮
少女の想起する淫事の激しさを類推することはできるだろう	而再将视线向下转移的话，也就会发觉，从她膣口淌流而下的淫液甚至连脚踝都彻底濡湿———仅从这点，大致也就可以类推少女想起的淫事的激烈程度了吧
「あっ，あっ......とーさま，はげし......すぎっ......」	「啊，啊...父亲大人，嗯...太激烈了...」
一人寝の寂しさを紛らわす......というには少々激しすぎる自涜は	%CALLNAME%正在为了消除孤身入眠的寂寞...而激烈地自慰着
今だ暫く終わりそうにはない	许久过后，%CALLNAME%方才是意犹未尽地停下了动作
荒淫の末，疲れ果てた%CALLNAME%の娘が眠りにつくのは，	荒淫末了后，%CALLNAME%已然是筋疲力尽
まだしばらく先のこととなるだろう	稍微等待片刻后，她也终于是进入了梦乡
「うぅ......。なんだか本格的にヘンタイさんになっちゃったなぁ」	「嗯...总觉得，真的要变成了变态了呢...」
「とーさまに嫌われないか心配だよ......」	「希望父亲大人不会因此讨厌我...」
「ねぇ，とーさま。閨でのやり口には，こーぎってのがあるんだって」	「呐，父亲大人，我听说有一种名叫“柯基”的家养犬...」
「そ。したあとにもっかいするんだって」	「如果说我想养的话..」
「え，違うって？　ま，いーじゃない。そんなこと」	「欸...不可以吗？啊...明白了呢，那种事情」
「とーさまのも元気だし，ボクもまだとーさまにじゅーりんしてほしいんだ」	「不过父亲大人看起来，好像还很精神呢...」
「だから，ね？」	「嗯...我也同样如此哦？」
「もっかいしよ，とーさま♪」	「那么。就再来一次吧，父亲大人♪」
%CALLNAME%はそう言って，仰向けのまま%CALLNAME:MASTER%に手を伸ばす	仰面躺着的%CALLNAME%这样说着，接着又再次向着%CALLNAME:MASTER%伸出了手
火照り，桜色に染まった肌	灯光映照在白皙肌肤之上，使得本来在情欲中泛起的淡淡樱粉变得又更加鲜艳些许
誘うようにわななく唇。情欲に潤み切った瞳	从那诱惑的粉嫩嘴唇与被情欲润湿的瞳孔中，这副身体主人的欲望此刻是清晰可见
視線を下に落とせば，太ももどころか踝まで愛液で濡らし，	视线向下移动的话，就会发现此时的她别说大腿，就连脚踝都已经被爱液濡湿了
今なお欲情に白く濁った蜜を吐き出す秘唇が，%CALLNAME:MASTER%を求め震えている	至今仍在强烈欲情下喷吐着混杂着白浊的淫汁的秘唇，在追求%CALLNAME:MASTER%而颤抖。
たまらず再び%CALLNAME%に覆いかぶされば，実娘は悦びの声を上げて足を絡めてくる	而在再度被欺身压上那时，%CALLNAME%便不禁发出了喜悦的娇声，同时双腿也主动缠住了父亲的腰肢...
......夜はまだ長い。不義の交歓は，まだまだ続くようだ	在这尚且漫长的夜晚中，不义的交欢就这般一直持续下去...
「ちぇー。とーさま，次はぜったいぜったい気持ち良くしてね？」	「哎———父亲大人，下次一定要让你舒服起来的哦？」
「いや，いやいや。とーさま，流石にそれはちょっと......」	「不...不了吧？爸爸，果然那种事情还是有点...」
「ね，とーさま。一緒に寝よ。父娘の身体接触ってやつだよ」	「呐，父亲大人。一起睡吧。是父女正常的身体接触哦」
「えっと，その......」	「那个...」
「特段一人寝が寂しいわけじゃぁないんだけど」	「才不是因为一个人睡很寂寞所以」
「あの，その......」	「那个，那个...」
なにやら当人にしかわからない葛藤の末なのだろう	这大概就是某种只有当事人才能理解的冲突吧
%CALLNAME%は%CALLNAME:MASTER%の前，	%CALLNAME%就这么趴在%CALLNAME:MASTER%怀里
枕を背に隠したままもじもじとしている	在里面害羞地蹭弄着...
「とーさまのニオイって安心するな」	「父亲大人的气味，令人安心呢...」
「いや，臭いとか特徴的とか，そんなんじゃなくってさ」	「不，没有什么味道，也没有什么特殊的地方」
「ここがボクがいるべき場所にいるって」	「只是会给我带来某种感觉...」
「何だかそんな気分にしてくれる気がするんだ」	「就好像是这里本来就是我应该在的地方」
%CALLNAME%はそう言って，%CALLNAME:MASTER%の寝巻の裾をぎゅっと握る	%CALLNAME%这么说着，同时也紧紧地握住%CALLNAME:MASTER%睡衣的下摆
普段のそれとは違うどこか安心しきったその表情は	与平日里的紧绷不同，就这般搂抱着自己的她终于是久违地露出了放松的表情
%CALLNAME:MASTER%の実娘の，年相応の側面であるのだろうか	%CALLNAME:MASTER%的亲生女儿，终于显露出了与年龄相对应的一面吗？
「とーさま，呑も，呑も♪」	「父亲大人，喝酒，喝酒~♪」
「え？　飲酒は二十歳になってから？　なんの話さ，それ」	「诶？喝酒要等到二十岁以后？为什么嘛，这种事情...」
「んぐ，んぐ，んぐ......」	「呼呼...唔...」
「はれ？　とーひゃまぁ，なんらか，まひゃりがゆみゃんでりゅ......」	「咕嘟咕嘟...唔...呼~~」
%CALLNAME%がラッパ飲みしている瓶には玫瑰露酒と記されている	%CALLNAME%正在对瓶吹的酒瓶上，写着玫瑰露酒的标签
......死なれる前に，彼女の痛飲を止めた方が良いだろう	...在醉到昏死过去之前，最好赶紧停止她的痛饮...
「お酒ってさ，いろんな種類があるよね」	「酒有很多种类呢」
「ね，とーさまのお勧めはどれ？　おしえてほしーな♪」	「呐，那么父亲大人会给我推荐哪种呢？好想听听看呀~♪」
%CALLNAME%は%CALLNAME:MASTER%の部屋の酒棚を見つつ	%CALLNAME%一边看着%CALLNAME:MASTER%房间的酒柜
実父の腕へと自らの腕を絡ませている	一边把自己的胳膊缠在了\@ TALENT:MASTER:性别 == 1 ? 她 # 他 \@的胳膊上
彼女の興味が，酒ではない別のものであるのは明白なわけであるが，さて......	她的兴趣不是酒，而是别的东西，这点很明显，那么...
「とーさま，お話して。なんでもいいから，さ」	「嗯...爸爸，请和我聊聊天吧。说什么都可以。」
「なんでかって？　そりゃ，ふつーの父娘には，そんな感じの身体接触があるものらしいからだよ」	「哎...为什么？那是因为，一般的父女之间，这样的互动都是很正常的吧？」
「ね，ダメかな......」	「喂，不行吗...？」
「ね，とーさま。ちょっと相談なんだけど」	「呐，爸爸，那个...有点事情需要找你商量」
そういって%CALLNAME%が持ち込んできた話題は，存外に真面目なものだった	%CALLNAME%这样说着，带来的话题是出乎意料地认真
父娘は討議し，考えを摺合せ，足りない知識を補い合い，目前の問題に取り組んでいく	父女俩就这般思考与讨论着，互相补充着彼此不足的知识，致力于解决眼前的问题
「うん。とーさまとのこーゆー時間もボクは好きだな♪」	「嗯...我也喜欢和父亲大人在一起的时间哦」
%CALLNAME%は書類片手に，%CALLNAME:MASTER%へと屈託のない笑みを向けている	单手拿着文件的%CALLNAME%，对着%CALLNAME:MASTER%露出了无忧无虑的笑容
「ねーとーさま。聞いてよ。今日こんなことがあってね......それで，それで......」	「呐，父亲大人。听我说。今天发生了这样的事...然后，然后...」
枕を持って%CALLNAME:MASTER%の寝台に潜り込んできた%CALLNAME%は	拿着枕头钻进%CALLNAME:MASTER%的卧铺的%CALLNAME%
%CALLNAME:MASTER%の腕に腕を絡ませ，その日の出来事を眼を輝かせて話している	把手臂缠在%CALLNAME:MASTER%的手臂上，兴奋地向\@ TALENT:MASTER:性别 == 1 ? 她 # 他 \@说着今天所发生的事情
「ねえ，とーさま。ちょっと，おねだりしてもいいかな」	「呐，父亲大人，可以拜托您一件事吗？」
そう言って%CALLNAME%は着物の裾をたくし上げる。下着を着けていないそこは，物欲しそうにひくつき，愛液を吐き出している	%CALLNAME%这样说着，卷起衣服的下摆，展示着自己那正在淫欲中不住淌流着淫液的真空小穴
「ううん，違うの。こっちに，ほしいの」	「欸...不是这里哦。我想要的是———这里」
そう言って%CALLNAME%は%CALLNAME:MASTER%の手を己の秘所ではなく，腸液で塗れた後ろの窄まりへと導いた	这么说着，%CALLNAME%将%CALLNAME:MASTER%的手指引到了自己肠液同样泛滥的后庭口处
「ボクをこんなヘンタイさんにした責任，とってよね♪」	「毕竟啊~把我变成这样的变态，父亲大人也肯定有相应的责任对吧~？要好好地负起来哦♪」
「折角とーさまと，激しく前後する関係になれてるわけだし」	「好不容易才和父亲大人发展到了这种程度的关系...」
「この手のことも勉強しないとこっかな」	「结果即使是这种事情也是不学习不行的吗」
「......立場と見てくれだけで」	「...只是站在我自己的立场上看的话..」
「とーさまを繋ぎ止め続けられるかは分からないしね」	「我不知道父亲大人会不会喜欢这种呐」
「えっと”女性の4階級の考察”？」	「那个“女性四级考察”？」
「”いろんな土地における女性の特質”？」	「“世界各地的女性的特质？”」
「......Vashikaranaってナニさ」	「...那Vashikarana又是什么？」
「うーん，舶来物のこの本，難しいなぁ」	「嗯，舶来品的这本书，好难懂啊...」
%CALLNAME%は時代背景を無視した書籍に頭を悩ませている	%CALLNAME%为无视时代背景出现于此的这些书籍而大伤脑筋。
「うーん，仏壇返しに鵯越えの逆落としに......」	「唔...这个是观音坐莲式，这个是鵯越降落式...」
「これ，ほんとに気持ちいのかなぁ？」	「这个...通过这些真的会让人更加舒服起来吗？」
「なんか無意味にアクロバティックな気が......」	「总觉得都是些毫无意义的杂技呢...」
どこから手に入れたのか，%CALLNAME%は時代背景にそぐわない	%CALLNAME%拿着不知从哪里得到的明显与时代背景不符的卷轴
巻物片手に性知識を学んでいる	并通过其上所写的内容学习着性知识...
「やったぁ！　待ちに待った野戦だぁ♪　とか言った方がいいのかなぁ」	「太好了！是期待已久的野战啊♪是这样说比较好吧」
「え？　字が違う？」	「诶？字写错了？」
「さーいくぞっ！　平押しに押して真っすぐ吶喊だいっ！　ごー！！」	「来———就这样去吧！平推他们！上！」
「全軍，鶴翼の陣！　ボクを囮にして包囲殲滅するよ！」	「全军，鹤翼之阵！以我为诱饵，将敌军包围歼灭！」
「全軍，鋒矢の陣！　ややこしいことされる前に全部食い破っちゃえ！」	「全军，锋矢之阵！在做麻烦事之前先把他们各个击破！」
「総員，偃月の陣！　乱戦に持ちこめ，ボクが大将首を取るっ！」	「全体人员，偃月之阵！开始混战，我去取他阵中大将的首级！」
「ボクの剣は無双なんだから！」	「我的剑技可是天下无双的！」
「......と，言えるくらいになりたいね。うん」	「...嘁...真想这么说啊」
「......投げても散弾に不能し，突いても心臓狙ったりしないけど」	「即使投出也无法散射以数量弥补精度，哪怕是挺枪刺杀也未必能够瞄准心脏...」
「だからって安全だと思ったら大間違いだい！」	「但如果只是这样就觉得自己是安全的话，那可就大错特错了！」
「びゅんびゅんびゅーん！」	「砰砰砰！！」
「ぐるぐる回してからぶつければ痛いんだい！　覚悟しろ！」	「转来转去的铁球，要是碰到的话会很痛的哦？！觉悟吧！」
「飛将に比べるべくもなかろうと」	「虽然无论是技巧还是力量，我无法与吕布相比...」
「ボクだっていっぱしの武人だい！　覚悟してかかってこい！」	「但至少，我也是一介武人！觉悟吧！」
「さぁ，ボクの蛇骨剛剣を受けたい奴は前に出ろ！」	「来吧，想领教我的蛇剑的家伙们，就给我滚到阵前受死！」
「え，世界観？　いや，まぁその辺は気にしないでもらえると......」	「啊，世界观？嘛，如果能不介意这一点的话...」
「熟練すればカミサマだって殺せる武器だ！」	「运用熟练的话即使是神明大人都能杀死的武器！」
「武威以前に危ないんだぞ！　覚悟して挑んで来い！」	「就这样面对我的武威可是很危险的！想来挑战的话就做好觉悟吧！」
「全軍，ボクに続け！　その辺一帯ごと薙ぎ払う！！」	「全军，继续进攻！杀光那群家伙！！」
「こっちだってそーとーしゅーれん積んでるんだ！　木端兵士が役に立つと思うなっ！」	「我们这般的人数也同样很多，别以为靠杂鱼堆积出的人数优势算些什么！」
「この%CALLNAME%が相手だっ！　命が惜しくないならかかってこい，周りごとぶっとばしてやるんだからっ！」	「%CALLNAME%就是你们的对手！不怕死的家伙全部给我滚到阵前受死！」
「......いい加減，そう言い張ったっていいと思うんだ」	「...算了，我觉得这样坚持倒也不错就是了」
「ヘンな効果はなくたって，狙った相手の心臓ブチ抜く程度はできるっ！」	「即使没有奇怪的效果，也能把你们的心脏都给拔出来！」
「死にたい奴からかかってこい！」	「不怕死的家伙就给我滚到阵前来！！」
「祖先から受け継ぐ「鉄球」ッ！」	「这可是我从祖先那里继承下来的「铁球」！」
「......なーんて物はないし，黄金長方形も関係ないけど」	「...没有什么特别的效果，和黄金矩形也扯不上什么关系」
「当たったらただじゃすまないぞ！　覚悟しろ！」	「但如果中了的话也得好好喝一壶！觉悟吧！」
「やぁやぁ，遠からんものは音に聞け，近くば寄って目にも見よ！」	「身在远方之人，就给我好好用耳朵来听着！而近处的家伙们...就给我好好见证你们阵前大将的悲惨死相吧！」
「天下無双を自称しても突っ込まれないレベルの武威，見せてやるんだから！」	「我就让你见识一下，就算是所谓天下无双的豪杰也无能匹敌的武威！」
「信じられないほど邪悪な見た目のスリケンは無くとも」	「即使没有那些邪恶的手里剑」
「ヘビ・ケンの用意ならあるぞ！　覚悟しろ！」	「但至少我的手里可是蛇剑已经准备好了哦！觉悟吧！」
「この武器が一本だけだなんて誰が言った！」	「谁说这把武器我的手里就只有一把！」
「六本全部受けてみろっ！」	「就这样好好见识一下六把电锯齐出的威力吧！」
「......え，不明なユニットが接続されました？　......何？」	「...欸，连接到不明单位...这是什么？」
「さあ，城壁上って吶喊だ！　みんな，付いてきて！」	「全军听令，攻城登梯！不怕死的跟我上！」
「皆，丸太......違った，破城槌は持ったね？　よーし，城門めがけて吶喊だぁ！」	「各位，那个木头...不，你们都有好好带着攻城锤吧？好，那么，现在就向城门发起冲击！」
「あーもう。ちまちまちまちまあんなところに閉じこもっちゃって」	「啊，真是的。竟然在那种地方闭门不出...」
「武人なら潔く城門開けて戦えばいいのに......」	「如果你们还算个有种的武士的话，就给我堂堂正正地出门打一架啊...！」
「手こずるようなら，城内に死体や汚物を投げ込んで」	「如果感到棘手的话，就把尸体和污物扔进城里」
「病を流行らせるべきなんだろうけど」	「应该就可以让流行病在里面开始传染起来吧」
「あんまりやりたくはないな」	「不太想这么做啊...」
「......占領した後の掃除が大変だし」	「这样的话占领之后的打扫就会变得很辛苦了...」
「総員そのまま突貫！　城門はボクが破砕する！」	「全军突击！城门就由我来粉碎！」
「城壁？　城門？　殴れば壊れるじゃん。気にせず吶喊だ！　ごーっ！！」	「城墙？城门？只要稍微一打就坏。别想那么多就好了，全部给我上！！」
「籠城なんてしみったれたことやる連中に，武威のなんたるかを教え込んでやるんだからっ！」	「我要好好地教导那些做着娘们一样事情的家伙们，什么才叫真正的武威！」
「居飛車穴熊ごときで止められると思うな！」	「不要以为能用居飞车穴熊那样的办法来阻止我！」
「棋盤ごとぶった切ってやるんだから！！」	「我连棋盘都给你砍翻！！」
「身体は鉄でできている―――――」	「钢铁为身，烈焰为...啊...」
「......と，とーさまが抱きしめてくれた時に痛そうだし」	「...这样的话父亲大人紧紧抱住我的时候会感觉很痛吧？」
「そもそも動きが鈍りそうで色々問題を感じるけど」	「而且感觉动作迟钝以外还会有很多问题...」
「地面に得物がいくつもある以上，丸腰のボクと闘えるとは思うな！」	「不过既然地上还有那些东西，就不要以为能和徒手的我战斗！」
振り抜く刃が砕ければ，	如果挥舞的刀刃碎了
雑兵の死骸から得物を奪ってまた振う	就从周边杂兵的尸体上抢来东西再甩
血と，肉と，骨片	甚至连血肉与骨骸都作为武器
そして余りの膂力に砕けた剣の鉄片が舞う戦場で	在被太过强大的膂力所击碎的剑的铁片四散飞舞的战场上
%CALLNAME%はまさに無限の剣をもって戦場を制圧していく	%CALLNAME%正以无限之剑制压着全场
「城門ってさ，閂壊せば普通に開くんだよね」	「城门啊，只要破坏了门闩，就会正常打开」
兵士たちが城門をくぐり敵城になだれ込む中	战士们穿过城门冲进敌城
%CALLNAME%はひとりごちる	%CALLNAME%则是独自一人站在城外
突撃に参加しない己の指揮官を咎める兵は一人もいない	没有一个兵会指责自己那不参加突击的指挥官
当然である	理所当然
何せ投槍の一撃で城門を撃ち抜き，閂を破砕し	毕竟用投枪一击打穿城门，粉碎门闩
一兵も損なうことなく城門を開いたのは，	就这样一兵未损地打开了城门
他ならぬ%CALLNAME%なのだから	也只有%CALLNAME%才能做到了
「城門ばかりに意識が行って，城壁への注意が薄い，か」	「不要只注意城门，城墙的防御力相比来说要更加薄弱」
「総員西壁に突撃！　城壁はボクが破砕する！！」	「全军听令，突击西壁！城墙就由我来粉碎！！」
「......ま，所詮鉄で補強されてたって，基本は木だしね」	「...嘛，就算是用铁来加固了，基础也还是木头」
「開かないならぶった切っちゃえば済むんだよね，城門って」	「城门的话，不开就直接砍掉算了」
%CALLNAME%が多節剣を振るうたびに	每当%CALLNAME%挥舞着手中的多节剑时
数十人の兵士が切断され，ばらばらになった五体が宙を舞う	都会有数十名士兵被直接切断，散落的尸块与鲜血在空中四散飘飞
人間だったものが飛散した”あとに”刃が宙を切る音の響く異様な光景に	当原本的人类四散开后，刀刃划破空气的声音才姗姗来迟
士気を保てる敵兵などいようはずもない	不可能还有能够在这般景象之下继续保持士气的敌兵
鬱々と降りしきる紅の雨の中，%CALLNAME%隷下の兵士たちは	在四散的腥红之雨中，%CALLNAME%所统率的士兵们
敵城を制圧すべく，粛々と進軍を続けていく	为了攻克敌城，继续庄严行军
「かみがばらばらになるかどうかは知らないけど」	「虽然我并不知道这把武器是否真的可以弑神」
「動かないでっかいものを壊すならこいつの出番だ」	「但至少，轮到需要破坏一个不动的大家伙的时候，就轮到这家伙出场了」
「覚悟しろ！」	「觉悟吧！」
唸りを上げて振るわれる%CALLNAME%のチェーンソーが	%CALLNAME%用力地拉响了链锯，随后便是重重地挥斩下来
分厚い城門を木端微塵に破砕する	厚实的城门就这样被缓缓地切了开来
実に直截的に無力化された城塞が制圧されるのは，時間の問題であろう	真正意义上已完全无力化的城塞，被彻底压制什么的也只是时间问题了吧
「悪いけど一歩だって通さないよ。......落城の上撤退戦とか御免だし」	「不好意思，前方可是一方通行啊...城池失陷后的撤退战什么的就免了」
「守勢に回るのは嫌いだけど，別に対応できないわけじゃないやい！　覚悟しろっ！！」	「虽然讨厌守势，但也不是不能应对就是了！给我觉悟吧！！」
「沸かした油，早く！　負傷兵はあっちの民家へ！」	「把桐油泼下去，快点！负伤兵赶紧转移到那边的民房！」
「え，ボク？　ボクはそりゃ，城門開けて正面突撃......」	「诶，我？我想打开城门正面突击...」
「あ，やっぱダメ？」	「啊，果然不行呢」
「あーもうまだるっこしい！　ボクだけ外に出て暴れちゃダメかな......」	「啊————已经很无聊了！不能只有我一个人在外面闹腾吧...」
「籠城なんてキライだー！　せめてボクと一騎打ちしろ～～～！」	「我讨厌笼城！至少出来和我一对一对打~~！」
「小勢率いて夜襲にでも行くかな。少なくとも被害ゼロで防げはしないだろうし」	「或许我会选择率领小股部队进行夜袭吧，毕竟不能让对方一点损失都没有...」
「あ，間抜け。引っ掛かったみたい」	「啊，笨蛋，你已经被我抓住了！」
「ふん，ボクだって小細工できないわけじゃないんだから！」	「哼，我也不是不会耍小聪明！」
「単純な策だけど，そうだからこそ案外うまくいくもんだね」	「虽然只是单纯的对策，但也正是因为如此，才能意外地顺利进行」
「改良版八門金鎖の陣！」	「改良版八门金锁阵！」
「生門から入っても壊滅するから，ゆっくり死んで行ってね♪」	「就算从生门进去也会迎来毁灭的结局，就这样慢慢地去死吧♪」
「あ，うん。やっぱりそう来たか」	「啊，嗯...果然是这样来了啊」
「......だからそっちに伏兵置いたわけだけど」	「...所以我才把伏兵放在了那里」
「相手の動きが予測できるなら，兵力の多寡にかかわらずこっちが有利だよね」	「如果能预测对方的动向的话，不管兵力多寡，这边都是有利的」
「......スパロボで敵増援の位置とタイミングが分かっているようなものだし」	「...就用超级机器人来了解敌人增援的位置和时机好了」
「あ，うん。なんか上手くいったみたい」	「啊，嗯...果然是这样来了啊」
「......兵の配置を間違えただけなんだけどなぁ」	「...只是兵的配置弄错了而已啊」
「え？　え？　なんであんなとこで戦闘が起こってるの？」	「诶诶？为什么在那样的地方发生战斗？」
「ボクがあっちに部隊を伏せておいたって？　......したっけ，そんなこと？」	「因为我把部队伏在那边了...做了吗，那样的事？」
「あ，何だかわからないけど敵さんが混乱してる」	「啊，不知道怎么回事，敌人的阵容好像发生了混乱...」
「おっかしいなぁ。特に何もしてないんだけど」	「好可怕啊，虽然我也没有做什么特别的事情」
「別に策を練れないわけじゃないんだ」	「并不是没有别的办法」
「大抵の場合，ボクが突っ込んだ方が手早いってだけで」	「不过一般情况下，还是说我亲自突入的话要更快一些」
「この%CALLNAME%がただの猪武者だと思ったら大間違いだい」	「如果觉得我只是个无脑的莽夫那可就大错特错了！」
「......まあ，突撃が好きなのは否定しないけど」	「...嘛，虽然不否认我的确喜欢冲锋」
「こっちの武威が高いと」	「如果单纯只是凭着我的武力强大这点」
「勝手にボクが策略下手だと思ってくれるからやりやすいんだよなぁ」	「来擅自断定我在策略方面很弱的话，那可是很容易熟的哦？」
「わ，びっくり」	「哇，吓了一跳」
「まさか教本通りにやった”策に引っ掛かったフリ”が通用するなんて......」	「没想到按照教条上所说的“假装被策略牵着鼻子走”什么的竟然真的能奏效...」
「相手の策の予想はできなくとも」	「即使不能预测对方的对策」
「堅実に軍を運用すれば案外奇手って防げるものなんだよね......」	「如果能踏实地运用军队的话，也意外的能防止奇手...」
「敵の策を想定し，あらかじめ対策を練っておく」	「设想敌人的计策，再事先研究对策」
「基本中の基本だね」	「这可是基本中的基本啊」
「......まあ，相手の策が分からないから。片っ端から対策しておいたんだけど」	「因为不知道对方的策略。我从一开始就采取了对策...」
「このボク相手にそんな策が通じると思ったの？」	「你觉得这样的策略对我来说行得通吗？」
「対策してるに決まってるじゃん」	「对策已经决定好了」
ジャーンジャーン	锵锵锵———————
銅鑼の音と共にあちこちから%CALLNAME%の軍旗がはためき，敵軍を包囲する	伴随着震耳欲聋的锣声，%CALLNAME%的军旗从各处飘扬，将敌军包围起来
「やーい，ばーかばーか」	「喂，笨蛋笨蛋」
「ボクがそんな策に，手を打ってないわけがないじゃないか」	「我怎么可能会不对这样的计策进行设防呢？」
「なんなら　げぇ，CALLNAME%！　とか怯えてくれてもいいんだよ？」	「就算你们现在摆出些“什么嘛好厉害，%CALLNAME%！”之类的惊慌样子也是没有关系的哟？」
「あ，うん。その策使うなら，やっぱりそこが本陣だよね」	「啊...如果对方使用那个策略的话，果然那里才是本阵吧」
「......ま，分かっていたからそこの近くの川」	「...嘛，因为知道那边附近有条河」
「上流で堰き止めておいたんだけど」	「虽然被从上游截断了」
「え，罠？　何時？　......ふっふっふ。ボクの目にかかればそんなのコドモダマシさっ！」	「诶，陷阱？什么时候？...呼呼，早就已经看破了哦」
%CALLNAME%の目は泳いでいる	%CALLNAME%的目光有些游移
「あ，なんか敵将が吃驚してる」	「啊，总觉得敌将很吃惊」
「良く分かんないけど，このまま突撃すればいいっぽい」	「虽然不太清楚，但只要这样冲锋就好了」
「皆，行くよ！　ごー！」	「全军出击，上！」
敵将の策は，%CALLNAME%に理解されることさえないまま木端微塵に粉砕された	敌将的计策，在连%CALLNAME%都不理解的情况下，就这样被粉碎了
「なんか知らないけど，敵っぽい小勢が目の前にいる」	「虽然不知道为什么，但是眼前有一支看起来像是敌人的小股部队...」
「こっちは道に迷っただけで，そもそもここ，主戦場じゃないのに」	「我只是迷路了，而且本来这里就不是主战场」
「ま，いっか。......殺っちゃえ♪」	「啊，算了...直接杀了他们♪」
「総員，小細工ごときに怯むな！」	「全体人员，不要害怕那些小伎俩！」
「このボクが率いる軍勢が，そうそう破れるわけがないっ！」	「我所率领的军队，是不可能那么被破的！」
策に浮足立った軍勢が，%CALLNAME%の根拠皆無の檄により統制を取り戻す	在策略上动摇的军队，由于%CALLNAME%毫无根据的命令，就这样重新取回了控制权
既に%CALLNAME%の雷名は，小賢しい策を上回る価値を持っているのだ	%CALLNAME%如雷贯耳的声名，已经有超过局部策略的战略价值
「総員退却！　目標，敵本陣！」	「全体撤退！目标，敌本阵！」
......退却とはなんであったか	...所以这真的是撤退吗？
%CALLNAME%の配下たちは首をかしげながらも	%CALLNAME%的部下们虽然不解
一振りで部隊を壊滅させる指揮官に追従し，戦果を挙げていく	但还是随着将军的一挥之下，追随着她一同取得了战果
「退却？　却下！　下がったらボクが斬る」	「退却？驳回！敢退下的胆小鬼就由我来亲自杀掉」
「全軍突撃！　ボクに殺されるか，敵兵殺して生き残るか，好きな方を選べ！」	「全军突击！是被我杀死，还是通过杀敌证明自己有资格活下去？选择自己的命运吧！」
敵の術中にはまったまま死ぬ気で敵陣に斬り込むことと	是死气沉沉地杀入敌阵，死于奋战之中
軍勢全員で%CALLNAME%一人に逆らうこと	还是军势全员一同对抗%CALLNAME%一人
どちらが生き残る可能性が高いかなど，明白である	哪一方生存的可能性更高，不言而喻
無双の武人の非情な命令に，%CALLNAME%の配下たちは悲鳴とも怨嗟ともつかぬ雄叫びをあげ	面对无双武人的无情命令，%CALLNAME%的部下们只能发出悲愤的呐喊
死兵となって敵陣へと斬り込んでいく	随后就这般化作无惧生死的杀戮机器，直接突入了地震
「突っ込め，突貫，突撃！　全軍，ボクに続けぇっ！！」	「冲锋，突击，突击！全军，给我继续！！」
「ふっふ～ん♪　小細工なんかしてるから，こーやって簡単にぶち抜かれちゃうんだっ！」	「呵呵~♪小聪明什么的，这样做就很容易的被打穿了！」
「賢しらな小細工ごとき，踏みつぶせばそれで済むことっ！」	「像聪明的小玩具一样，只要踩坏了就没问题了！」
「全軍，隊列を崩すな！　このままぶち抜けっ！！」	「全军，不要破坏阵型！就这样冲出去！！」
「大将首さえ取れば戦術なんざ無視して構わない！　どけぇぇぇっ！」	「取得大将的首级，就可以无视他们的战术！只要这么做就好了！」
半ば音を置き去りにした%CALLNAME%の一撃が，部隊ごと敵指揮官の思惑を粉砕する	%CALLNAME%的一击使得一半的人都欢呼起来，敌方各部队指挥官的意图就这么被粉碎了
圧倒的な暴力の前には，常人の集団を用いた戦法は意味を持ちえないのだ	在压倒性的暴力面前，使用常人集团的战法是没有意义的
「そ・こ・かぁぁぁぁぁっ！」	「那里...给我去吧啊啊啊啊！！」
全力で投げつけられた%CALLNAME%の槍が，攻城兵器ごと敵指揮官部隊を吹き飛ばす	被全力投掷的%CALLNAME%之枪，将敌方指挥官部队连同攻城兵器一同击飞出去
人，馬，荷駄の区別なく天へと放り出される非常識な事態の前には	在人马牲畜都被这般不分青红皂白地被抛到天上的非常识的事态面前
いかなる指揮官であっても，まともに部隊を運用することは不可能であった	无论是什么样的指挥官，都不可能认真地运用部队
動揺し，指揮を受けられない軍団へと駄目押しに放たれた第二撃によって，	由于向动摇，没有指挥的军团发出了无可奈何的第二击，
敵軍の計略は完全に無意味化されるのであった	敌军的计谋完全被无意义化了
「小細工ごときでボクを止められると思うな！　どけぇぇっ！」	「别以为能用小伎俩阻止我！滚开！」
風どころか音より速い%CALLNAME%の連撃が，敵部隊を完膚なきまでに壊乱させ	%CALLNAME%的连击速度已然超越音速，眨眼间数百记引发音爆炸响的暴击，就这般使得敌方部队彻底崩溃
計略を無意味化させていく	所采用的策略也被彻底无意义化了
極めた個人の武は，戦術，戦略に勝るものなのである	属于个人的极端武力，就这般胜过了一切的战术与谋略
「―――――っ！」	「――――！」
物も言わずに振るわれた%CALLNAME%の武器が天を，地を，大気を破砕する	%CALLNAME%挥舞的兵器，引起了天崩地裂的异象
音を，風を，稲妻を置き去りにし。光にさえ迫らんとする超神速の一撃が	在风暴与闪电之前到来的，连光都迫近的超神速的一击
大気との摩擦で莫大な熱と光を放ち，耳を劈く轟音でもって敵部隊を威圧する	猛烈的一击在与大气的摩擦中放出巨大的热和光，以震耳欲聋的轰鸣声威压着敌方部队
熱波による上昇気流が短期間のうちに莫大な量の雲を上空に呼び込み，未曽有の豪雨を招来する	热浪引起的上升气流在短时间内将上空的云层压缩成块，导致了前所未有的巨大暴雨
人どころか大地にさえ当たっていない一撃で天候をも変えてみせた%CALLNAME%の前に	别说人了，即使是大地也未曾命中，稍微用力地挥手便改变了天气
態々戦いを挑もうとする兵士などいるわけもない	在这般强大的存在面前，没有一个士兵想与之为敌
敵味方が呆然と立ち尽くす中	敌我呆然伫立
敵指揮官がどんな思惑を持っていたかなど，もはや誰も気にしようとはしなかった	至于敌人指挥官有什么样的想法，已经没有人在意了
「あれ？　このセリフが出るのっておかしいよ。貫計(武闘)の記述がおかしいんじゃないかな」	「咦？这种台词说出来的话会感觉很奇怪？可是贯计(武闘)这种东西的难道就不奇怪了吗」
「とーさまが待ってるんだ，絶対回家んだ！　こんなのなんてことないやいっ！」	「父亲大人在等我，所以我一定要回家！怎么可能就这样败在这里！」
「舐めるなっ！　とーさまとボクの”らぶらぶぱわー”の前に，そんな小細工が通用するかぁっ！！」	「别小看我！在爸爸和我的“爱之力量”面前，这样的小伎俩可是无法奏效的！！」
「とーさまが待ってるのに無様を晒せるかっ！」	「父亲大人在等我，怎么可能就这样败在这里！」
「全軍突貫，ボクが軍鋒を行く！」	「我行军锋，全军突击！」
「小賢しい細工なんざ......このままブチぬけぇぇぇぇっ！」	「真是聪明的小伎俩啊...就这样留在这里吧！」
「とーさまへの愛とこの剣にかけて！」	「就用对父亲大人的爱和这把剑！」
「小難しい策なんかぶっ潰してやるんだからっ！」	「把你们这些家伙和这小小技俩全部都摧毁掉！」
「回家んだ，またとーさまに愛してもらうんだ！」	「回了家，就可以享受父亲大人的宠爱了！」
「こんなところで，死ねるかぁっ！」	「怎么可能会死在这种地方！」
裂帛の気合と共に投擲された%CALLNAME%の槍が	裹挟着裂帛的气势一同被投掷而出的%CALLNAME%之枪
その馬鹿げた速度と質量によって地表を破砕し	以胡闹般的速度和质量破坏了地表
敵陣の最奥で莫大な土砂を跳ね上げる	直接贯穿至敌方阵地的最深处，掀起了遮天蔽日的土沙
無数に撥ね飛ぶ石により敵兵が次々と打ち抜かれ，倒れ伏し	敌兵被四散的飞沙走石挨个击倒在地
巻き上げられた砂塵が指揮官の視界を完全に覆い隠す	卷起的沙尘彻底掩盖了指挥官的视野
最早敵方に作戦の遂行など不可能であった	先前对敌方的作战计划已被事实证明是不可能的
火事場の馬鹿力か，本当に%CALLNAME:MASTER%への愛情が実現したものなのかはさておき	是本身就具备着这胡闹般的力量，还是真的是因对%CALLNAME:MASTER%的爱情而创造出的惊人奇迹姑且不论
敵軍の策が崩壊したのは間違いないようだ	反正敌军的策略肯定是彻底崩溃了
「とーさまのところに一番乗りするんだから！」	「我要第一个到达父亲大人的身边！」
「そんなややこしい作戦，一々構っていられるかぁ！」	「只是这么简单的策略，不知你能否应付得来！」
「戟に炎や誇りを纏うような器用な真似はできないけど」	「虽然不能灵巧地模仿着他，在戟上缠绕着火焰与武将的骄傲」
「とーさまへの愛情ならいつだって全開だいっ！」	「但只要凭着对父亲大人的爱，无论是在什么时候都可以全开！」
「策でボクを止められると思うなっ！」	「别以为用计策就能阻止我！」
「なんか羽がいっぱいついた女の人に教わったこの技」	「从长满翅膀的女人那里学到的这个技能」
「雷出せる神通力が無くとも，とーさまへのらぶらぶぱわーがあれば！」	「即使没有呼风唤雨的神通之力，只要有对父亲大人先生的爱之力量...就够了！」
「やっぱこの武器使うなら人皮でできた仮面でも被った方がいいのかなぁ」	「果然使用这个武器的话，还是要戴上人皮做的面具比较好啊」
「でも，流石にそれじゃぁとーさまも引くか......も......？」	「但是，这样的话也会吸引父亲大人...？」
「いや，とーさまも倫理観が相当にアレだし，案外......」	「不，父亲大人的伦理观也是相当差劲的，意外地重合了...」
%CALLNAME%は1800年ばかり未来予知したネタについて，真剣に悩んでいる	%CALLNAME%因脑中莫名浮现的，本应存在于千年后的未来的段子而认真地苦恼着
「あちゃぁ，やっちゃったなぁ」	「啊，搞砸了」
「自軍もまともに統率できないんじゃぁ，とーさまに合わせる顔もないよ」	「即使是自军也没能好好统率啊，就连和父亲大人见面的脸都没有...」
「うーん，まさかお館様がやられちゃうなんて」	「嗯，难道是主君大人被打败了吗？」
「とーさまのことだから，無体な扱いはしていないと......あ，いや。大分心配だなぁ......」	「因为是“父亲大人”，所以应该不会粗鲁地对待...啊，不，还是好担心啊...」
「ん，とーさまにそこまで言われちゃ仕方がないや」	「嗯，既然父亲大人说了那我也没有什么办法」
「これからはよろしくね，とーさま♪」	「那么今后也请多多指教了哦♪」
「......ごめん，とーさま」	「...对不起，父亲大人」
「いくらとーさまの頼みでも，やっぱり譲っちゃいけないものってあると思うんだ」	「就算是父亲大人的请求，果然不能让步的东西还是有的」
「とーさまの娘が尻軽の裏切り者だなんて。ボク，絶対いやだもの......」	「父亲大人的女儿竟然是轻浮的叛徒，这种事情我绝对不喜欢...」
「え，放逐されるの？　あ，うーん。そうだね」	「诶，要被放逐吗？啊，嗯...明白了...」
「ほっとしたような，寂しいような，悔しいような......」	「感觉好像松了一口气，但心里却又寂寞又不甘心...」
「血を分けた娘だろーとさっくり投獄」	「喂喂...是亲生女儿吧」
「やっぱりとーさま。公私の区別はちゃんとつけてるんだなぁ」	「果然是父亲大人呢，对公事与私事还是分得很清楚啊...」
「いや，ま。乱世の習いだし，特段恨み言は言わないけどさ」	「不，没有哦，因为这是乱世的习惯，所以说...我不会有什么太多的怨恨」
「ちょっと寂しいかな。あはは」	「但还是会感觉...有点寂寞吧，哈哈...」
%CALLNAME%はそう言って乾いた笑いを上げ，抵抗するでもなく淡々と首切り役の元へと連れられて行った	%CALLNAME%轻声笑着，并没有做些什么抵抗，就这般淡然地被带到了刑场
首を落とされる段になっても平然と，従容としたその振る舞いは	即使到了将要被砍下脑袋的阶段，她也依然从容不迫
まさに武人のそれとして語り草になったという	据说作为一名武士，后来的她已然成为民间的传说...
「あはは......ボクはここまでかぁ」	「啊哈哈...我就这样到此为止了吗？」
「とーさまは，無事かな。無事だよね。......無事に決まってる」	「不知道父亲大人是否平安无事...啊啊...不，他吉人自有天相...肯定不会有事的」
「ごめんなさい，とーさま。生身ではこれ以上一緒にいられないみたいです」	「但是...还是对不起，父亲大人，活着的时候，已经不能再在一起了」
「でも大丈夫。%CALLNAME%は魂魄のみとなろうと，鬼となろうと，魔物となり果てようと」	「但是，没关系哦。%CALLNAME%就算变成魂魄也好，化身恶鬼也好，转生成魔物也罢」
「とーさま，あなたの御傍に......」	「只要能够陪伴在父亲大人身边...」
「こいつも乱世の習い，ショッギョ・ムッジョってやつかぁ」	「这就是所谓的乱世啊...诸行无常」
「それじゃ，ま......サヨナラ！」	「那么，就这样吧...再见了！」
%CALLNAME%は爆裂四散はしなかったが，しめやかに最期を迎えた	并没有四散爆裂之类异象，%CALLNAME%优雅地迎接了自己的凋零
「あちゃ，ここまでか」	「啊...我就这样，要到此为止了吗？」
「ま，いいや。折角だし，最後まで暴れようかな」	「但是即使是我，也有不能放弃的东西，所以...」
「ちょっと楽しみだしね」	「就让我在生命的尽头，最后再盛放一次吧...」
「......文字通り，力尽きるまで　斬りあうってのも」	「生如樱花，死亦绚烂」
%CALLNAME%は降伏の勧告に応じることもなく，最期まで戦った	%CALLNAME%没有接受投降的劝告，就这样战斗到了最后
その結果が戦局を揺るがすことは無かったが，	虽然最终的结果也并没有动摇战局
彼女の苛烈な最期は史書の中で後々まで語られ	但她惨烈的临终，必然会在史书上留下浓墨重彩的一笔
人々の記憶に刻まれることとなった	也深深地刻印在后世人们的记忆中
「え，いいの？　多分ボク，またとーさまと戦うことになるけど」	「嗯，可以吗？也许我会和父亲大人再次兵戎相见...」
「......いや，ま。乱世の習いといえばそんなものかもしれないけど，さ」	「...不，算了。说起乱世的话，也许本来就应该是那样的」
「え？　とーさまと一緒の陣営に来いって？」	「欸？要加入父亲大人的阵营吗？」
「そりゃ願ったかなりだよ，おっけー♪」	「那是我许的愿望哦，好开心♪」
「ごめんなさい，とーさま。お仕えできません」	「对不起，父亲大人，我无法选择您作为侍奉的主君」
「やっぱさくっと二君に使える様な振る舞いはマズいと思うんだ」	「毕竟，我觉得给父亲大人带来麻烦什么的事情...是不好的」
「とーさまの娘が倫理観に乏しいなんて話になったら，とーさまに不利益だもの」	「如果父亲大人的女儿缺乏伦理观这种事情传出去的话，对爸爸的名声也是不利的」
「......ところで，なんで胡乱な目でこっちを見てるのさ」	「...诶，我说的话很好笑吗？为什么用那种眼神看着这边嘛」
「ボクにだって倫理観くらいあるよ？」	「原来我也有伦理观...什么的？」
「え？　投獄？」	「诶？下狱？」
「うろちょろされると困るって程度に評価されてると喜ぶべきか」	「被评价为除了关起来外其他的做法都会让人困扰，嗯...我应该高兴吗？」
「登用に値しないと見なされてると嘆くべきか」	「应该感叹于自己被认为是不值得录用的角色这种事情吗？」
「反応に困るなぁ」	「不知道该作何反应呢...」
「......まさか，牢に繋いで調教したいだけだったりしないよね？」	「...还是说，爸爸单纯只是想把我关在牢房里调教嘛？」
