「えっと、初めまして。貴方がボクのとーさまなの？」	「啊，初次见面，你就是我的父亲吗？」
「ふうん。まあ、よろしくね」	「嗯...那么，请多关照？」
「父娘でそーいう関係ってなんだか”はいとくてき”だね！」	「这样的父女关系总感觉有些太过于亲密了啦...」
「え、背徳的の意味？　……だいじょーぶ、わかんなくたって生きていけるよ！」	「欸...会不会有那种背德的感觉...？没关系，就算不知道那种东西也不是不能活下去嘛！」
「えへへ……なんだか恥ずかしいね」	「嘿嘿...总觉得有点害羞呢」
「とーさま、その……また接吻、しようね……」	「爸爸...那个，下次再好好接吻一次吧？」
%CALLNAME%は真っ赤な顔でそう言って、俯いてしまった。	通红着脸蛋的%CALLNAME%轻声说道，接着便羞得低下了头
「とーさま！　またボクに会いに来てくれたんだ」	「爸爸———！今天也是来看我的吗？」
「うん、すっごく嬉しいよ。で、今日は何する？　何する？」	「嗯，当然！为此我非常开心哦？这次想要和人家做什么呢———」
そう言って%CALLNAME%は跳ね回らんばかりの様子で %CALLNAME:MASTER%を見つめている。	%CALLNAME%欢快地说着，绕着%CALLNAME:MASTER%打起了转
「とーさま♪　……ううん、呼んでみただけ」	「父亲大人~♪...哼哼，只是觉得好玩就这么叫一下哦？」
「嫌だった？」	「欸...没有讨厌什么的吧？」
%CALLNAME%は上目づかいで、 %CALLNAME:MASTER%を見上げている	%CALLNAME%稍微抬起头来，用无邪的目光注视着%CALLNAME:MASTER%
「『きょーはいーひだな』」	「『今天也请多指教』」
「『だってたぼーなとーさまが、ぼくにじかんをさいてくれたんだか……ら……』」	「『我最好的朋友啊...谢谢你愿意在我的身上花费这么多时间』」
「って、もう。なにさ！　笑わないでよ」	「啊...啊，什么嘛！不许笑啊！」
「こないだ見たお芝居でそんな台詞があって」	「前些日子看过的戏剧里面有这样的台词」
「いいなぁ、って思っただけなんだからさ。もうっ！」	「只是觉得"真好啊"而已...呀啊！」
「とーさま、来てくれたんだ。嬉しいな♪」	「爸爸，你来啦？好开心~♪」
「で、どうする？　訓練？　お喋り？　警邏？　それともえっちなこと？」	「那，想来和人家做什么呢？训练？聊天？巡逻？还是别的什么有趣的事？」
「うん、ボクはどれだっていーよ」	「嗯，不管是怎么样都可以」
「何れにしたってとーさまと一緒に過ごせるんだもの」	「只要能和爸爸一起度过一段时光的话...」
「ボクが厭う理由なんて、一欠けらだって存在しないよ」	「我就已经很满足了哦」
「えっと、とーさま。今日もその……するの？」	「嗯，爸爸，今天也是...要做吗？」
「ほら、はやくはやく。はやくしないと、とーさまと一緒の一日が早く終わっちゃうよ！」	「快点快点———再快一点，如果再不快点的话，本来可以和爸爸在一起的时间就要这样被浪费掉啦！」
出会いがしらに飛びついてきた%CALLNAME%はそう言って、%CALLNAME:MASTER%の腕に抱きついてきた	飞奔出来的%CALLNAME%一头撞进了%CALLNAME:MASTER%的怀中，并紧紧抱住了\@ TALENT:MASTER:性別 == 1 ? 她 # 他 \@的手臂
「とーさま、来てくれたんだ。今日はどうするの？」	「爸爸，你来啦？今天想要做点什么吗？」
「ねえねえとーさま。あのさ、あのさ……」	「喂———爸爸~那个...」
「えっと、あー……うーん……やっぱり、なんでもないや」	「啊...没什么啦」
%CALLNAME%は寂しそうな表情で、 %CALLNAME:MASTER%に笑って見せた。	欲言又止的%CALLNAME%不禁露出了寂寞的表情，接着也还是对%CALLNAME:MASTER%露出了笑容
「あ、とーさまだ。何しに来たの？」	「啊，爸爸，怎么啦？」
「むにゃ……もう呑めないよぅ……」	「喵...已经喝不下了...」
%CALLNAME%は酒瓶を抱いて気持ちよさそうに眠っている	抱着酒瓶的%CALLNAME%舒舒服服地睡着
「はっ……ひゃぅぅ……。とーさま、激しすぎだよ……」	「哈啊啊...♥爸爸，太舒服了...♥」
聊か焦点の合わない瞳を虚空に彷徨わせ、%CALLNAME%は様々な体液に彩られた肢体をしどけなく横たえている	浑身遍布着体液的%CALLNAME%无力地躺在床上，那在快感刺激中变得失焦的瞳孔朝着半空散射出朦胧的视线
「うーん、つーかーれーたー」	「啊...好累...」
ばたんきゅーと態々口で言ってから、%CALLNAME%は倒れこんだ。幾ばくも待たぬうちに、穏やかな寝息が聞こえてくる	就这么轻声说完过后，%CALLNAME%便无力地倒下了。没等多久，就听到了平静的呼噜声
「えへへ。とうとう、きんしんそーかんしちゃったね」	「欸嘿嘿...终于...做到这个地步了呀...」
「ふふ、嬉しいなぁ。とーさまが、とーさまってだけじゃなくて」	「呵呵...好开心呀？爸爸~」
「別の意味でも、ボクの大切な人になってくれたんだもの……」	「即使是血缘关系之外的意义上，你也都是我重要的人呢...」
「もー。とーさまも罪な人だなぁ」	「姆，真是个罪孽深重的家伙呢」
「血を分けた娘の大切なものを奪っちゃうなんて、どういう了見をしてるのさ……」	「竟然夺走了身为分血的女儿这么重要的东西，你到底是怎么想的呀...」
言葉とは裏腹に%CALLNAME%は%CALLNAME:MASTER%の腕に身を絡ませ、愛おしげに頬を擦り付けている	尽管嘴上这么说着，但%CALLNAME%的身体却仍缠绕在%CALLNAME:MASTER%的手臂上，眼底充满着爱意
「とーさま、ぜったい、絶対また来てね♪」	「爸爸~下次一定要再来呀♪」
「とーさま、明日も会えるよね？」	「明天也能再见吧？爸爸」
「とーさま。ボクのこと、ちゃんと見てね？」	「爸爸，请...好好地看着我哟」
「あれ、もうそんな時間なんだ。とーさまといると、時間が早く過ぎちゃうみたい」	「啊呀...竟然已经到这个时候了吗？和爸爸在一起的时间感觉过得真的好快呢...」
「うーん。父娘の関係って、随分な障壁っぽい……」	「嗯...父女的关系什么的，真是麻烦啊...」
「うん、またね。とーさま」	「嗯，再见啦。爸爸」
「うぅ……もーだめ。ねぇ、とーさま。エッチしようって呼んどいて、これはないよ……」	「唔...不要嘛。喂，爸爸，来做爱吧，虽然...唔...」
「はっ、はっ、はっ、はぁ……。とーさま、激しすぎ……」	「哈啊~哈啊...爸爸，太激烈了...」
息も絶え絶えに、しかしどこか恍惚として。%CALLNAME%はしどけなく身を横たえている	用恍惚的眼神凝望着天花板的%CALLNAME%静静地躺在床上，呼吸因疲累而显得一抽一抽的
「もーだめ。ふらふら。おやすみなさい、とーさま」	「不行啦，感觉天旋地转的...晚安，爸爸」
ばたんきゅー、と態々口で言ってから。%CALLNAME%は倒れこみ、静かな寝息を立て始めた	就这么轻声说完过后，%CALLNAME%便无力地倒下了。没等多久，就听到了平静的呼噜声
「ふふっ……。ね、とーさま。ボクで気持ち良くなってくれた？」	「呼呼...爸爸，我有让你感觉到舒服了吗？」
「え、ボク？　そりゃボクは、とーさまがしてくれるならなんだって気持ちいいよ」	「欸...我吗？只要是能和爸爸在一起，我就会感觉很开心哦」
「ん……ちゅっ……えへへ。初めてがとーさまだなんて、嬉しいな♪」	「唔...啾~嘿嘿...第一次什么的，真是太开心了~♪」
「ん……んんっ……。もー、父娘の身体接触としては、行き過ぎな気がするなぁ」	「呜姆...嗯...感觉这种事情对于父女这种关系来说还是太过分了啦...」
「んっ……とーさまの舌が、ボクの口を犯してるみたいで……んっ、ちゅっ……」	「唔嗯...呼♥爸爸的舌头...就像是在侵犯我的嘴一样...」
%CALLNAME%は口腔を舐りまわされる感覚に頬を上気させ、	%CALLNAME%的脸颊因口腔遭受舔舐而不禁染上粉红，随后便是主动向上稍微抬起头来
さらなる深い交わりを求め舌をからめてくる	彼此间互相缠绕着舌以求得进一步的交合...
「ん……とーさま、ボクの唇、乾いてたりしない？　ヘンじゃない？」	「唔嗯...爸爸，不觉得我的嘴唇很干吗？嗯...」
「んっ……。まぁ、いまさらだけどさ」	「唔...嘛，反正，事到如今」
「乙女の唇まで奪ってるんだ。とーさま、ボクをちゃんと大切にしてね？」	「连少女的嘴唇都已经夺走了。爸爸，请好好地珍惜我吧」
「うん。とーさまが望むなら、いいよ」	「嗯。如果可以的话，那就...太好了」
「なんだか、ぽかぽかするよ」	「总觉得...很温暖呢」
「あれ……なんだかびりってする」	「呀...感觉，麻麻痒痒的...」
「と、とーさま。こっちも……して」	「爸爸...爸爸，这边也摸摸嘛...」
%CALLNAME%は %CALLNAME:MASTER%の手に触れ、より強い刺激を受けられる場所へと誘導した	%CALLNAME%轻轻攥住了%CALLNAME:MASTER%的手腕，将其拉到能够造成更强刺激的地方
「や、乳首かんじゃだめぇ……く、クリトリスはもっとだめ……ひゃぁっ」	「不，乳头不行...阴蒂也不行...嗯啊♥」
「とーさま、もっと、もっとして」	「爸爸...再，再更多抚摸一点...」
「ひゃぁぁぁっ！　と、とーさま。ボク、感じすぎちゃって……」	「嗯啊啊~~爸爸...好过分...♥」
「っ～～～～～！」	「呀啊~~~♥」
%CALLNAME%は%CALLNAME:MASTER%の愛撫に嬌声を上げ、瑞々しい肢体をびくり、びくりと震わせた	%CALLNAME:MASTER%的爱抚动作激得%CALLNAME%不住发出着娇媚的声音，纤柔的身躯不住地颤抖着
「く、首筋はだめだよっ……敏感になってるから……って、そこも」	「唔嗯...不要摸脖子了啦...那里也很敏感的说」
「ひゃぅっっ！」	「呀啊啊~~♥」
「んっ……、あっ……」	「嗯...啊啊...」
「ふふっ……すっかりとーさまに開発されちゃったね」	「呼呼...身体完全被爸爸开发了呀...♥」
「とーさまに犯してもらえるって考えただけで……んっ」	「脑子里已经只想被爸爸侵犯什么的了...呼呼...」
「……こんなに濡れちゃってるよ……」	「已经完全湿透了啊...」
「んっ……とーさま。痛いのはやだよ？」	「嗯...爸爸，不会弄疼我的对吧？」
「胸？　うん、とーさまならいいよ」	「胸部...？嗯唔，如果是爸爸的话...」
「えっと、その……痛く、しないでね？」	「那个...不会弄疼我的吧？」
「とーさま、くすぐったいよ」	「嘻...爸爸，好痒啊~」
「ん、何だかヘンな感じ……」	「嗯唔，总感觉好奇怪...」
「ねえ、とーさま。もっと……」	「啊...爸爸，可以更多摸摸这里吗...？」
「ひゃっ……乳首噛んじゃダメっ、そこ、弱いからっ！　きゃぅっっ」	「唔嗯...乳头...很敏感的，别...别这样捏呀...♥」
「ひゃぅっ！　だ、ダメっ！　胸、敏感過ぎておかしくなっちゃう」	「呜唔...不，不行，胸部敏感过头了...♥！」
「このメッセージが出るのはおかしいよ。バグ？」	「这句台词在正常情况下是不会出现的，是什么BUG吗？」
「ひゃうっ……。んっ……なんだか……胸の先が変な感じで……」	「啊呀...总感觉，胸部，好奇怪...♥」
「わひゃっ！　だ、ダメ……そこ抓んじゃ……ひゃぅっっっ！」	「呜...哇啊♥别，别抓那里...哈啊啊~~」
「んー、とーさま。くすぐったいだけなんだけど……」	「嗯唔...爸爸，感觉胸口...好痒啊...」
「えーっと、その……。そこを舐めるのはどーかなって思うよ」	「那个...舔那里...不会感觉很奇怪吗？」
「ち、違うよ。ちゃんと綺麗に洗ってきたもん！　え？　なら大丈夫だろうって？」	「嗯...虽然有好好地洗干净呢，欸...那应该就没问题了...吗？」
「そっか、それもそう……うん？　いや、けど、でも……あれ？」	「啊，那也是呢...」
「と、とーさま？　どこ舐めようとして……ひゃぁっ！」	「爸...爸爸？想要舔那里...呀！」
「とーさま、ボクはちゃんと洗ったよ？　洗ったけど……そこはどうかと思うなぁ」	「爸爸，我这里...有好好地洗干净吗？虽然洗过了，但我总感觉好像还有点...啊，真的没关系吗？」
「う……あ……。とーさま、なんだか変な感じだよ」	「呜啊...爸爸，总觉得好奇怪啊...」
「な、なんか腰の奥がぴりってきて……んっ……」	「喂，总觉得腰后面...好奇怪，嗯...」
「だ、ダメ。クリトリス吸っちゃだめっ……って、中をかき混ぜるのもだめっ」	「呜嗯...阴蒂，不要这样吸啊，还有里面也不要...嗯嗯♥」
度重なる愛撫で柔らかく解れた%CALLNAME%の秘唇は当人の言葉とは裏腹に淫らに打ち震え、	被用反复的温柔动作缓缓分开的%CALLNAME%的秘唇，正与本人言语相反的淫荡地打着颤
紅玉のように赤く充血して震えるクリトリスと共に、%CALLNAME:MASTER%の愛撫を待ちわびている	因充血而鼓胀膨起显得宛如红玉般的阴蒂，正焦急地等待着%CALLNAME:MASTER%的爱抚
「ひゃっ……は……あ……やぁぁぁ……きゃぅっっっ！」	「哈啊...啊...啊...嗯啊啊...！」
球の様な汗を裸身に浮かべ、%CALLNAME%は華奢な太ももで%CALLNAME:MASTER%の頭を挟み込む	赤裸的娇躯上遍布着汗水的%CALLNAME%，在刺激中不禁夹紧了用她那纤细的大腿夹紧%CALLNAME:MASTER%的脑袋
%CALLNAME:MASTER%の舌先が蠢くたびに、鋭い嬌声が白い喉を震わせる	每当%CALLNAME:MASTER%的舌尖蠢动时，清脆的娇声便会从那稚嫩的喉中涌出
もはや言葉を発する余裕もなく。血を分けた幼子は、%CALLNAME:MASTER%の愛撫に翻弄されていった	已然没有额外精力去分神说话的，身为%CALLNAME:MASTER%分血的幼女，正被她的父亲肆意爱抚与玩弄着
「とーさま、怖いよ。感じすぎて、怖いから……あぁぁっ！！」	「好可怕...爸爸，好可怕，嗯啊啊啊~~！」
言葉とは裏腹に、%CALLNAME%は己の淫唇に%CALLNAME:MASTER%の頭を押し付けるように動いている	与此时口中的言语相反，%CALLNAME%正努力地挺着腰，就像是在刻意将把那淫唇按在%CALLNAME:MASTER%的头上不住扭动着腰
触れればはじけそうなまでに充血したクリトリスに吸い付くと、%CALLNAME:MASTER%の眷属は	仿佛是稍加触碰就会爆裂开般发情充血的阴蒂就这般任由%CALLNAME:MASTER%肆意地舔舐着
痙攣するかのように空腰を振り、涙さえ浮かべた瞳で天井を仰ぎ見た	%CALLNAME%在快感的刺激下就好像痉挛使得不住颤抖着，在那正仰望着天花板的眼中，兴奋的生理眼泪正在肆意流淌着
「は……あ……。とーさま、ダメ……ほんとに、狂っちゃ……あぁぁぁぁぁっ！！！」	「啊啊...哈...不，不要，爸爸...我真的，要疯掉了...嗯啊啊啊啊啊~~~~~~~！！」
%CALLNAME%は限界まで目を見開き、つま先をぎゅっと丸めて快感に耐えている	将眼睛睁大到极限的%CALLNAME%，正紧紧地蜷曲着脚尖忍耐着快感
開発されつくした秘唇は、%CALLNAME%に許容量以上の快感を与えているらしい	已然被彻底开发的淫唇，稍加触碰便会为%CALLNAME%带去超越极限的快感
震える淫貝の中を%CALLNAME:MASTER%の舌が蠢く毎に、白濁した愛液が脈動するように放出されている	每当%CALLNAME:MASTER%的舌头在女儿那颤抖着淫贝中蠢动时，白浊的爱液就会在痉挛中不住地喷涌而出
「んっ……ふ……あっ……」	「嗯...呼...啊啊...」
「うん、気持ちいよ。気持ちいけど……これって父娘の身体接触って領域を」	「嗯唔...虽然很舒服，但这样...完全都把父女之间的关系应有的界限...」
「遥彼方に置き去りにして……って、ひぅぅっっ！　喋ってる間にお豆さん噛んじゃダメ……」	「直接都抛到九霄云外去了...唔...哈啊~~说话的时候不要咬人家的小豆豆啊...♥」
「んっっっっっ～～～～～！！」	「哇啊~~~~~！！」
「ねぇ、とーさま」	「喂，爸爸」
「やっぱこれって、どう考えても娘にやることじゃないと……ひゃっ、くすぐったいって！」	「果然这个，不管怎么想都不是应该对女儿做的事...啊啊，被舔得都要痒死了...！」
「最初はちゃんと、とーさまのおちんちんで奪って欲しかったなぁ……」	「人家的第一次啊...想要好好地让爸爸的鸡鸡夺走呢」
「え？　入れない？　周りをほぐすだけ？」	「诶？不用进去吗？只用好好地放松一点...」
「ほんとに？　ほんとにほんとだよね？」	「真的吗？真的是这样吗？」
%CALLNAME%は不安そうに、%CALLNAME:MASTER%の指の動きを見つめている	%CALLNAME%不安地注视着%CALLNAME:MASTER%的手指的动作
「わっ！　とーさま、タンマタンマ！　幾らなんでも指が最初ってのは……」	「呜哇...爸爸，第一次什么的，用手指还是...」
「え？　入れないの？　うーん、じゃぁいいのかなぁ……」	「欸...不用进去吗？我想...那应该就没问题了吧」
「んっ……指で解してくれるんだ」	「嗯...用手指来这样的话...」
「とーさまにじゅーりんされる分には、別にいのに……優しいんだね」	「不过之前父亲大人明明没什么...唔，不过现在倒是很温柔呢」
「初めての時も、こーやってちゃんと解してほしかったかなぁ……」	「第一次被父亲大人的手指摸这里...虽然还是更想正常地来呢」
「あぅっ……んっ……とーさまぁ」	「啊...嗯...父亲大人...」
%CALLNAME%は情欲に曇った瞳で%CALLNAME:MASTER%を見上げ、甘い声を上げる	%CALLNAME%用情欲模糊的眼睛仰望着%CALLNAME:MASTER%，口中此时也发出甜美的声音
「ボク、もう大丈夫だよ」	「嗯...我现在，没事了哦」
「とーさまのおちんちん、受け入れられるよ？」	「已经...可以接受父亲大人的鸡鸡了哦？呐？」
「だから、ねぇ……ねぇ……」	「所以，就不要用手指了嘛...」
「んっ……なんか、へんなの……」	「嗯...总感觉，好奇怪啊...」
「でもこれだけ入念にしてくれるってことはその……」	「但是只是用手指都这么细心的话...」
「……やっぱり入れたら痛いのかなぁ」	「...所以把那个东西放进来肯定会很疼的吧？」
%CALLNAME%は%CALLNAME:MASTER%の屹立したものを見て、不安そうにつぶやいている	%CALLNAME%看着%CALLNAME:MASTER%身下那根挺立的东西，不安地嘟哝着
「とーさま、はぅっ……んっ……」	「爸爸，啊...嗯...」
「指じゃなくて、とーさまので……」	「我想要的不是手指，而是爸爸的...」
「んっ、あっ……とーさまの、おっきいから」	「嗯，啊...因为爸爸的鸡鸡太大了」
「最初に解してくれた方が、とーさまの形、覚えられる気がするな……」	「第一次被填满的记忆，已经彻底刻印在里面了...」
「とーさまが望むなら、どこだって……。でも、ほんとに大丈夫？　病気になったりしない？」	「如果爸爸想要的话，那里也不是不可以...但是，真的不会生病的吗？」
「いや、ちょっとストップ。とーさま、そこはさすがに絶対違うって、考え直し……ひゃぁぁぁっ！」	「嗯...嗯啊，稍微停一下...爸爸，那里的话肯定绝対不是...请再更多考虑一点啊啊~~♥」
「え゛、いや、ちょっと待って。とーさま」	「欸，等，等等...爸爸」
「そこ入れるとこじゃなくて出すと……ひゃうぅぅっ！」	「那里不是能放进东西的地方，现在拿出来...呜呜...！」
「うぅ……とーさま、そこは苦しいからやめて欲しいよ……」	「呜嗯...爸爸，那里也不会多敏感的啦...拜托您不要再这样做了...」
「んー、なんかムズムズするかも？　うん、痛かったりはしないよ」	「唔...大概就是有点痒？嗯，不会疼哦」
「なんだか、変な感じが……ひゃっ……指曲げちゃダメ！」	「总感觉好奇怪...呀啊♥手指不要这样动啊...」
「ひっ……あぅぅ……。えへへ、なんだかすっごく”とーさまに調教された”って感じがするな♪」	「啊...啊。呼呼，总觉得有种像是“被爸爸调教着”一样的感觉啊...♪」
「うん、もっとし……ひゃぁぁっ！　指増やしちゃ……やっ……」	「嗯...再更多抚摸一点...嗯噫♥不...太多了啦...」
「ひゃ……あっ……。お尻、あんまり弄らないで……敏感になりすぎてて……辛いっ……から……」	「嗯呀...啊♥不要...不要这样欺负屁股...太敏感了啊...哈啊♥」
「ああぁぁぁぁっ！！」	「嗯啊啊啊~~~」
「……流石に、そこはどうかと思うけどなぁ」	「竟然会对这种地方感兴趣...你到底是怎么想的啊...」
「うん、いいよ。とーさま、来て」	「嗯，好啊，那么就来吧？爸爸」
%CALLNAME%は頬を染め、%CALLNAME:MASTER%に向かって両腕を差し出した	悄然间已被染红脸颊的%CALLNAME%，主动向着%CALLNAME:MASTER%伸出了双臂
「ふつー、こうするのが一番最初だと思うんだけどなぁ」	「我觉得最开始的那时候应该用这种姿势来做才对...」
%CALLNAME%は少し寂しそうにそう言って、%CALLNAME:MASTER%の頭をかき抱いた	%CALLNAME%似乎是有点寂寞的样子，语毕后便主动抱住了%CALLNAME:MASTER%的头轻轻蹭着
「落ち着く体位だね。とーさまの心臓のとくとくって音が……ひゃぁっ」	「很亲密的体位呢...爸爸心跳的声音都完全听见了，扑通扑通的...」
「ちょ、ちょっと。もーちょっと気氛を慮ってくれても……あんっ、ひゃうっ！」	「等...等等啊，至少考虑一下气氛什么的...呜啊~哈...♥」
「こーやってのしかかられて、押さえつけられてるとさ」	「就这样被压住疼爱着...」
「とーさまにじゅーりんされてるって感じがして……んっ……」	「感觉有种被父亲大人彻底征服了的感觉啊...啊啊...」
「ひゃぅぅっ！　もー。ちょっとは喋らせ……ひあぁぁっ！！」	「呜啊，嗯♥至少让我先说完...啊啊~~」
「ふぁっ……とーさまのが、奥をこつん、て……」	「嗯...爸爸的肉棒...插得好深...啊啊...」
「とーさま、出したいんだね？」	「爸爸，想射进来吧？」
「娘のしきゅーに一杯出して、懷孕させちゃいたいんだよね？」	「想把精液注入女儿的子宫，就这么让她怀孕吧？」
「え、ボク？」	「欸...爸爸问我吗？」
「そりゃぁ勿論、欲しいよ。とーさまのせーえきも、とーさまの子供も」	「当然呢，想要...怀上爸爸的小宝宝」
「ん……ちょっと辛いけど、大丈夫。ボクで気持ち良くなって……」	「嗯...虽然有点痛，但没关系哦。我现在...很开心哦」
%CALLNAME%はぎこちなく笑って、 %CALLNAME:MASTER%に足をからめた	%CALLNAME%轻声笑道，主动抬起双腿缠住了%CALLNAME:MASTER%的后背
「とーさま、この格好すごく恥ずかしいよ……」	「爸爸...这种姿势也太难为情了吧...」
「こっちからのほうが痛くないの？」	「欸，这样的话就不会那么疼了吗？」
「うーん、じゃぁ仕方がないのかなぁ……」	「嗯唔...那也就没办法了呢...」
「うしろからするの？」	「欸...想从后面来做吗？」
「ちょっと恥ずかしいけど。とーさま、来て……」	「虽然有点不好意思呢...那就来吧，爸爸」
「とーさま、なんかこつん、て。ボクの奥に、とーさまのが接吻してて……」	「欸...爸爸，有什么诀窍吗？在我的里面，和爸爸的肉棒接吻...」
「んっ……凄い……このまま出したら、簡単に懷孕しちゃいそう……」	「啊...原来如此吗？就这样射进来的话，很容易就会让我怀孕的吧？」
「ひぅっ！　とーさま、ケダモノみたい……」	「呜哇...爸爸的动作，未免也太粗暴了吧...」
「実娘を押さえつけて、後ろからおちんちん突っ込んで……」	「就这样把女儿按住，像是和野兽交尾一样粗暴地插进来...」
「ひっ！　あぁっ！　いいよ、射精して……娘の膣内に、白いの一杯出してっ！」	「嗯，啊啊♥！就这样...射出来吧，狠狠地用精液把女儿的里面灌满...！」
「はっ……あっ……」	「哈...啊啊...」
「後ろからだと、入れられたおちんちんにばっかり気が行っちゃって……」	「就这么从后面来什么的...让我全身心地去侍奉爸爸的肉棒...」
「やっ、あ……あぅっっ！」	「哈啊...啊啊♥！」
「とーさまの形、覚えちゃう……とーさまのおちんちんじゃないとイけない」	「已经彻底记住了爸爸的形状...恐怕以后除了爸爸的肉棒之外的东西都彻底满足不了我了吧」
「エッチな近親相姦娘になっちゃう……ひゃぅぅぅっ！」	「简直就是那种乱伦主题的色情小说里才会发生的事情...呜啊啊♥」
「なんか、すっごく奥まで入ってて……ちょっと怖いかも」	「感觉像是...进到了很深的地方，有些害怕呢...」
「やっ……おちんちん、ボクの奥を抉ってて……んっ……」	「啊啊...爸爸的鸡鸡，在里面这样挖着...嗯...♥」
「とーさま、放さないで。ボク、飛んで行っちゃいそ……ひゃぅぅっ！」	「爸爸...不要停下啊，我感觉...像是脑子都要飞走了，呜啊啊~~♥」
「ふふっ……とーさまの顔が見えて、抱きしめられてて……」	「呼呼...就这样被紧紧地抱着，和爸爸互相看着彼此的脸」
「んっ……この体位も……ボク、好きかも……」	「嗯...这个体位，我...说不定会很喜欢哦」
「んっ……あ……う……いっ……た……んんっ……～～っっ！」	「嗯...啊啊，唔...哈，嗯...~~♥」
%CALLNAME:MASTER%の膝に乗せられる形で抱かれた%CALLNAME%の秘唇に、肉棒がぶちぶちと捻じ込まれる	在被放在%CALLNAME:MASTER%的怀中紧抱着的%CALLNAME%，正用她那窄小紧致的蜜穴侍奉着她父亲的肉棒
目に涙をたたえながらも、%CALLNAME%は%CALLNAME:MASTER%に心配をかけまいと必死に悲鳴を押し殺す	虽然眼里噙着泪水，但%CALLNAME%还是为了不让%CALLNAME:MASTER%担心，拼命地抑制着悲鸣
そんな実娘の首筋に舌を這わせ、胸やクリトリスを愛撫しながら腰を振ることなくじっくりと	伸舌舔舐着女儿的脖颈，同时双手也在爱抚着她的胸口与淫核
征服したばかりの処女地を堪能していると、%CALLNAME%が振り向き、接吻をねだってきた	正在%CALLNAME:MASTER%还在满意于方才征服的处女时，%CALLNAME%便是回过头来，开口要求着接吻
「んっ……ちゅ……えへへ、おなかの中で、とーさまのがびくびくしてる」	「嗯...啾~肚子里...爸爸的肉棒一颤一颤的呢」
「動いて、いいよ。あっちこっち弄ってもらえるから気がまぎれるし」	「就这么动来动去的...弄得人家很舒服呢」
「それにボク、僕のナカで、とーさまに気持ちよくなってほしいんだ」	「而且我，也希望用我的身体，让爸爸开心」
「うっ……痛っ……んっ～……とーさま、大好き。大好き……だよ……つっ……」	「唔...啊啊...哈~最喜欢父亲大人了...最喜欢了...哈啊，哈啊...♥」
少しでも痛みを少なく、早く終わらせてやろうと、%CALLNAME:MASTER%は愛撫を繰り返しつつ	不会允许女儿因为自己受到哪怕半点的痛楚，%CALLNAME:MASTER%不断重复着爱抚尽可能的试图平息着%CALLNAME%所受到的那些不适的刺激
いまだ未成熟な娘の中を蹂躙していった……	就这么蹂躏着尚未成熟的幼女的身体...
「と、とーさま。今胸いじっちゃ……ひゃっ！」	「爸...爸爸，胸口也同时玩弄什么的...呀啊~！」
「く、クリトリスまでするのはダメッ！　感じすぎて……あぁぁぁっ！」	「啊啊...阴蒂也不行，感觉...太过分了...哈啊啊~！」
「おちんちんずぼずぼするの待ってっ！　そんなあっちこっち……っ～～～！！」	「要被侵犯到喷出来了...到处都是什么的，啊啊~~♥」
「とーさまの心臓がとくとく言ってるのが聞こえるよ」	「感受得到爸爸心脏的跳动...」
「背中でもナカでもとーさまを感じられて……んっ……嬉しいな……」	「不管是背上，还是身体里呐...呼呼，好开心呐...♥」
「うん、ボクが上になるんだね？　分かった」	「嗯...骑在爸爸的伸舌吗？我明白了」
「えっと、それじゃあとーさま。ボクの初めて、貰ってね」	「嗯，那么...爸爸，就这样收下我的第一次吧」
そう言って%CALLNAME%は、%CALLNAME:MASTER%にまたがり、思い切りよく腰を落とす	这么说着，%CALLNAME%主动跨上了%CALLNAME:MASTER%的身体，用尽全力地坐了下来
肉棒がぶちぶちと何かを引き裂く感触と共に、愛液とは違った液体が結合部を濡らす	伴随着肉棒刺破某层略带韧性的黏膜组织的感觉，些许比之淫液要稍微粘稠些许的温热液体便混杂着破碎的组织顺着结合部淌流而下
「いっ―――――たぁっ……」	「咿————呀啊...」
目に涙を浮かべ、%CALLNAME%は、%CALLNAME:MASTER%の上に倒れこむ	在疼痛下眼里含着泪水的%CALLNAME%不禁猛然脱力，倒在了%CALLNAME:MASTER%的身上
良く頑張ったと撫でてやれば、%CALLNAME%は目端に涙を湛えたまま笑みを浮かべた	稍微给予片刻抚摸以后，眼角含泪的%CALLNAME%的脸上便浮现了笑容。
「よかったぁ。ボク、とーさまにちゃんと初めてをあげられたんだ……」	「太...太好了。我的第一次，就这样好好地送给了父亲大人呢...」
「うん、後悔なんてない。幸せだよ、とーさま」	「嗯，没有后悔，心里只有幸福哦，爸爸」
「大丈夫。ボクは平気だから、動いて欲しいな。最初は肝心なんだ。とーさまに、気持ちよくなってほしい」	「没关系哦，嗯...所以，请继续吧？第一次是很重要的哦，所以也希望爸爸能开心起来」
「ボクが上に？　わかった」	「诶，让我也动吗...？明白了」
「それじゃぁ、とーさまは動かないで。ボクが、気持ちよくしてあげ……ひゃぁっ」	「那么，爸爸就不要动啦，让我也好好地开心起来...呼呼」
「い、言ってるそばから突き上げちゃダメ……あっ……きゃぅっ！」	「呀，刚说完就这样往上顶...啊...嗯啊♥！」
「この体位、ごほーししてるって感じで、なんだか好き。ボクで気持ちよくなってね、とーさま♪」	「这个体位...让我感觉很舒服呢，好喜欢~父亲大人♪」
開発された肉壁が、%CALLNAME:MASTER%のものを複雑克妖艶に締め付ける	被开发后的肉壁，复杂而妖艳地紧紧缠绕着%CALLNAME:MASTER%的肉棒
%CALLNAME%は己の内部を抉られる快感に嬌声を上げつつ、	%CALLNAME%为体内不住传来的快感而发出着娇声，
%CALLNAME:MASTER%に快楽を与えることを優先し、腰を振っている	优先考虑着让%CALLNAME:MASTER%感到快乐，就这么扭动着腰
「それじゃぁ、とーさま。ボクが動くからじっとして……ひゃっ、あぅぅっ！」	「啊...爸爸，我会动的哦，所以请不要这样顶...呜，呜啊~~」
「ちょ、ちょっとまっ……ひっ、やっ、んぁっ！　や……」	「等，等一下...啊，嗯啊，呀~~唔...」
「だ、だめだよ……んっ、ひうっ♪　今は、ボクがごほーしする……ひゃぅっ！」	「不...不要，真是的♥明...明明我都在好好动着什么的...呀啊~！」
下から突き上げられた%CALLNAME%は膣を実父に犯される悦楽に嬌声を上げながらも	从下面被不断地顶撞着的%CALLNAME%为被父亲侵犯的喜悦不断地提高着娇声
幼娘はどうにか主導権を握り返そうと無駄な努力を繰り返している	同时也不断徒劳地试图争取着主动权
「んっ……あっ……いま、ずりゅっ　って……」	「嗯...啊...哈啊~啊...」
己の体重と重力の助けを借り	凭着自己的体重和重力
普段よりも深いところまで%CALLNAME:MASTER%の肉棒を受け入れた%CALLNAME%	在比平时更深的地方接受着%CALLNAME:MASTER%的肉棒的%CALLNAME%
愛おしげに己の下腹部を撫でながら、どこか正気を欠いた潤んだ瞳で、%CALLNAME:MASTER%のまなこを覗き込む	饱含爱意地抚摸着自己的小腹，用看不出理智的湿润眼睛凝视着%CALLNAME:MASTER%的样子
「ふふっ……このまま出したら、きっとボク、懷孕しちゃうよ」	「呼呼...就这样射进来的话，我一定会怀孕的吧...♥」
「うん、そう。ボクを作ったせーえきで、ボクが赤ちゃんをつくっちゃうの」	「啊啊...是这样呢，就像是妈妈生下我一样...我也会生下一个孩子」
「とーさまのおちんちんが、ボクのおかーさんになるための大事なトコロをじゅーりんして」	「然后，爸爸的鸡鸡所射出来的精液，也是组成孩子身体的重要的一部分」
「膣内もその奥も、とーさま専用に作り変える……」	「所以啊，不管是孩子小穴还是里面，都是父亲大人专用的...」
「とーさまで構成されたモノが、とーさまのモノになる……」	「由爸爸所提供的精液所构成的孩子，也会成为爸爸的所有物...」
「ねぇ、それってさ……」	「呐，所以啊...」
「すっごく、素敵なことだと思わない？」	「爸爸不觉得这是很棒的事情吗？」
情欲と、それよりもなおも悍ましい何かに炯々と光る%CALLNAME%の眼に魅入られるように	%CALLNAME:MASTER%被闪烁着比起原来要更强烈的情欲之光的%CALLNAME%的眼睛所迷惑
%CALLNAME:MASTER%の肉棒が実娘の膣を突き上げる	就这么用肉棒猛地顶上了女儿的膣口
「ひゃっ、あっ、はっ……やぁんっ♪　とーさまったら、そんなにボクで興奮してくれて……」	「嗯，啊...啊...哈啊~♪爸爸的肉棒...让我这么兴奋...」
「ひゃぅぅぅっ！」	「呜啊啊~~」
%CALLNAME:MASTER%の抽挿に、%CALLNAME%の裸体が淫らに踊る	%CALLNAME:MASTER%不住地抽插动作，使得%CALLNAME%的裸体淫乱地舞动着
熱病に浮かされたように実娘の膣奥へと叩きつけられる剛直	那好似发烧般炽热坚硬的肉棒猛烈地冲击着亲生女儿的膣穴深处
普段よりも荒々しい活塞運動に未成熟な雌芯を蹂躙されながらも	用比平时更加粗暴的活塞运动蹂躏着她未熟的花心
%CALLNAME%は心底嬉しげに嬌声を上げ、	令%CALLNAME%打心底里地高兴地娇声尖叫
悦楽に狂った瞳の奥にどこか計算高いものを秘めたまま	在那欣喜若狂的眼眸深处，隐藏着某种可怕的算计
より%CALLNAME:MASTER%の快楽を引き出そうと、膣を締め付けている	%CALLNAME%为了能够更加引出%CALLNAME:MASTER%的快乐，主动地将膣穴收紧
「ボクが上になるの？　分かった……んっ……きつ……い……」	「让我骑上来吗？明白了...啊...嗯...」
いまだ硬さの残る肉壁が、%CALLNAME:MASTER%のものをきつく締め付ける	仍然紧致的肉壁，紧紧地绞缠着%CALLNAME:MASTER%的肉棒
%CALLNAME%は少し苦しそうにしながらも、健気に%CALLNAME:MASTER%の上で腰を振っている	%CALLNAME%虽然看起来有些辛苦，但还是很坚强地在%CALLNAME:MASTER%的身上扭动着腰肢
「あっ、うっ……はっ、あぁっ！」	「啊，唔...啊...啊...！」
「こ、こっち向きでとーさまのが入ってると」	「啊...就朝这边，把爸爸的鸡鸡插进来吧」
「いつもと擦られるところが違って……ひゃんっ♪」	「跟往常摩擦的地方不一样呢...喵♥」
「んっ……と、とーさまも。ボクの膣内の、別のところで気持ち良くなって」	「嗯...用爸爸的肉棒在我的小穴里抽插什么的...浑身都好像舒服起来了...」
「飽きさせなんかしないんだか……ら、んっ！」	「永远都不会对这种事情腻烦呢...啊...嗯...」
「ひゃっ……あぅっ！　ボクの身体に……溺れさせ、ちゃうんだから♪　ひぅっ！」	「哈啊...爸爸就这样，沉溺在我的身体带给你的快感里吧...♥哈啊♥」
常とは違う場所を擦られる快楽に戸惑いながらも、	对于与平常不同的地方被摩擦的快乐而感到困惑的同时
%CALLNAME%は必死に%CALLNAME:MASTER%に快楽を与えんと奉仕を続けている	%CALLNAME%拼命地为%CALLNAME:MASTER%带去着快感，以此来继续为其服务
「んっ……この体勢、とーさまの顔が見えなくて寂しいよ……」	「唔嗯...这种姿势，看不到爸爸的脸，好寂寞啊...」
%CALLNAME%は未だ硬さの残る膣で%CALLNAME:MASTER%に奉仕しつつ、	%CALLNAME%用那依旧紧致的膣穴为%CALLNAME:MASTER%服务的同时
寂しそうにぽつりとつぶやいた	用夹带着些许怨念的语气轻声嘟哝着
「んっ……。こっち向きでしてくれるんだ」	「唔...想要，这样做吗？」
「そーだよね、どっちに入れるにしたって”初めて”には違いないものね」	「是呢，不管是哪里，都肯定有对应的“第一次”吧」
「いーよ、来て」	「嗯...请吧」
「とーさまので、ボクの”初めて”、奪って欲しいな♪」	「我希望，父亲大人能够夺走我的“第一次”」
そう言った%CALLNAME%は潤んだ瞳で%CALLNAME:MASTER%を見上げ、	%CALLNAME%那样说着，用湿润的眼睛仰望着%CALLNAME:MASTER%
両腕でその首をかき抱き、実父の剛直を不浄の器官に受け入れる	接着，便用双手抱住了%CALLNAME%的脖子，以那不净之所接受了父亲的肉棒
「ひゃっ……はっ……う、ぐっ……」	「啊呀...哈，唔嗯...啊啊...」
みちみちと排泄器官を押し広げられ、涙目になりながらも	排泄器官被逐步扩张的%CALLNAME:TARGET%的眼角不禁溅出了些许的泪花
%CALLNAME%は健気に苦痛の声を押し殺し、なんとか括約筋を緩めようと苦闘する	%CALLNAME%努力压抑着痛苦的声音，努力地放松着括约肌迎接着肉棒的插入
「んっ、んぅっ……ひっ……ぐっ……」	「嗯...嗯，啊...唔...」
「大丈夫、大丈夫だよ」	「啊...没关系，我不要紧的」
「とーさまに処女だけでなく、こっちの初めてまで奪ってもらえるんだもの」	「不光是处女，竟然连这边的第一次也能被夺走啊...」
「辛いなんてわけ、ないじゃない」	「啊，说的不是痛苦之类的意思哦，爸爸」
「もー、とーさまったら」	「啊呀...真是的」
「ほんとに娘のお尻を性具にしちゃうなんて、んっ……」	「居然真的把女儿的屁股也当成了性具吗，唔...」
「ね、とーさま。前でも後ろでも感じちゃうえっちな実娘」	「呐，爸爸，对于我这个不管是前面还是后面都能感受到你的鸡鸡的亲生女儿」
「もっと犯したいでしょ？　じゅーりんしたいでしょ？」	「你肯定想再更多侵犯一点的吧？」
「うん、ボクは勿論。とーさまにちょーきょーされるの、大好きだよ♪」	「啊，当然。被父亲大人侵犯什么的~最棒了♪」
「ん、ぐっ……き、つ……」	「嗯，呼...啊...啊...」
「でも、とーさまにどっちの穴も捧げられてるんだもの」	「把这边的洞也奉献给父亲大人什么的」
「嫌なんてことなないよ」	「并没有什么讨厌的哦」
「それに、とーさまのことだもの」	「而且，是爸爸的事嘛」
「とーさまの娘を、お尻でも感じられるヘンタイさんにするつもりは、あるんでしょ？」	「爸爸打算把自己的女儿变成即使是屁股也能感觉到的变态吗？」
「だから、掻きまわして？」	「那么，就更多搅弄一下吧？」
「お尻の中も、とーさまのモノを受け入れられる、せーきにかえちゃって？」	「爸爸想把我的屁股也改造成能够感受到鸡鸡的地方...」
「とーさまの手管でボクのお尻を、排泄器官じゃない」	「既然这样的话...那我的屁股从此除了排泄器官之外」
「とーさま専用の性具に、エッチな玩具に変えて欲しいな♪」	「就是父亲大人专用的，处理性欲的淫荡玩具♥」
「んっ……この体勢、好きだな」	「嗯...我喜欢这个姿势」
「だってとーさまに組み敷かれて、制圧されて、支配されてるって」	「因为啊，有那种，非常强烈的感觉」
「すごく実感できるもの」	「被父亲大人压制着，支配着的实感...」
「抱きしめられるんじゃなくて、押さえつけられて」	「不是被拥抱，而是被狠狠地压住」
「エッチのための穴じゃない」	「并不是为了那些色情的事情而存在着的洞」
「とーさまがせーきに作り変えてくれた穴を犯されてる」	「也被爸爸作为性器来侵犯了」
「ボク自身がとーさまの”モノ”になってるって」	「我已经成为了父亲大人的东西...」
「とーさまが望むオモチャになれてるって」	「变成父亲大人所期望的玩具了」
「全身で感じられるんだから」	「全身都能感受到」
「向かい合って、抱き合って」	「互相拥抱」
「接吻して、見つめ合って……」	「亲吻，凝视彼此...」
「ふふっ……でもでも犯すのは」	「呼呼...但是被侵犯的却不是那里」
「アソコじゃなくて、お尻なんだね」	「而是屁穴呢」
「すっごい性癖異常で、ゾクゾクするな♪」	「性癖异常的程度，让人不寒而栗的说♪」
「んぐっ……あ、痛っ……」	「呜哼...啊，好痛...」
「へ、へーきだよ。とーさま」	「欸，没关系的，爸爸」
「まだ、慣れてないだけ」	「只是还不习惯而已」
「すぐにこっちも、とーさまの為のせーきになるから」	「马上，这边也会成为父亲大人的玩具的」
「んちゅっ……あっ、むっ……んっ……」	「嗯...啊，唔...嗯」
「ふふっ、接吻してくれるんだ、優しいね」	「呼呼...被父亲大人就这样温柔地亲吻着...」
「うん、このまま動いて」	「嗯，就这样继续吧」
「接吻して、抱きしめて、ボクのお尻に」	「亲吻我，拥抱我，把我的屁穴...」
「とーさまの形を教え込んで……」	「也好好地变成父亲大人的形状」
「……お尻に入れるの？　ううん、嫌じゃないけど……」	「...要放到屁股里吗？姆，虽然并没有讨厌什么的」
複雑そうな表情の%CALLNAME%を抱きかかえ、今だ誰も迎え入れたことのない秘貝の後ろ、	%CALLNAME:MASTER%怀抱着表情复杂的%CALLNAME%
ひくつくアナルに肉棒をあてがうと、そのまま娘の体を下ろし、一気に貫いた	随后便将肉棒对准那未曾迎入他人的蜜贝后那窄小的肛门，就这样放下了女儿娇小的身体，一口气插了进去
「ひぐっ……あっ……かはっ……」	「嗯...啊，哈啊...」
目をいっぱいに見開いて天を仰ぐ%CALLNAME%を抱きしめ、硬くしこり充血したクリトリスや乳首に指を這わせる	怀抱着仰望天空的%CALLNAME%，将手指伸向了她那充血而勃起的阴蒂和乳头
「ひぁっ……やっ……広げられて苦し……って、ダメ……今クリいじっちゃ……なにっ……これっ」	「哈...啊...被这样扩张开，好疼...啊，不行...现在连阴蒂也刺激什么的...不行，啊啊♥」
初めて体験する圧迫感と、複数個所への愛撫。%CALLNAME%は苦痛とも快楽ともつかぬ感覚に身を震わせている	也不知是快乐还是痛苦，第一次体验的压迫感与对复数处的爱抚的感觉使得%CALLNAME%不住地颤抖着
複雑そうな表情の%CALLNAME%を抱きかかえ、愛液に塗れ、ひくつく秘貝の後ろ、	%CALLNAME:MASTER%怀抱着表情复杂的%CALLNAME%
物欲しそうに口を開けたアナルに肉棒をあてがうと、そのまま娘の体を下ろし、一気に貫いた	随后便将肉棒对准那淫水泛滥的蜜贝后的，那充满欲望地张合着的窄小肛门，就这样放下了女儿娇小的身体，一口气插了进去
幼子の開発されたアナルは貪欲に肉棒を締め付け	幼女那已然被彻底开发的肛门贪婪地勒紧了插入其间的肉棒
あちこちへの愛撫に嬌声を上げる%CALLNAME%に呼応するように、太腿まで濡らすほどの腸液を分泌している	仿佛呼应着%CALLNAME%对四周的爱抚那般，分泌着数量大到连大腿都濡湿的肠液
%CALLNAME%はいまだ解れていないアナルを無理やり押し広げられ苦しそうにしながらも	尚未放松的菊穴被迫扩张开来，%CALLNAME%不禁因疼痛而颤抖着
%CALLNAME:MASTER%の膝の上で複数個所への愛撫に身を震わせている	同时在被%CALLNAME:MASTER%放在膝盖上，对身体多处的爱抚动作中颤抖着身体
「やっ、あっ、ひゃんっ♪」	「嗯啊~哈...啊啊♥」
「と、とーさまちょっと……あっ、まっ……てっ！」	「爸...爸爸，嗯...啊呀，哈~~」
「んんっ！　……だ、駄目だよ」	「嗯...！不，不行...」
「ぼ、ボクがとーさまを……気持ちよく……するんだから」	「我...我会让爸爸舒服起来的...」
「だからお尻の穴、突き上げちゃだめぇぇぇぇ♪」	「所以，不要这样顶人家的屁穴呀啊啊~~♥」
「んっ……づ、あ゛、あ゛……」	「嗯...哈啊~哈啊...」
「あ、あはは。やっぱり自分から入れるのは」	「啊，哈啊...果然还是要进来吗」
「ちょっと辛いかな……」	「有点胀呢...好疼...」
「でも大丈夫。そんなに待たせないよ」	「但是，没关系哦，我会努力侍奉父亲大人的」
「とーさまのおちんちんを受け入れているんだもの」	「因为接受了爸爸的鸡鸡嘛」
「すぐにこっちもえっちな穴に変えて」	「所以...很快这里也会变成能够插入的小穴~」
「とーさまを骨抜きにしてあげるんだから♪」	「让爸爸舒服到骨头都化掉的~♥」
「はっ、はっ、はっ……」	「哈啊...哈啊...」
「この向きだと、とーさまのおちんちんが」	「啊...朝着这个方向的话，稍微低头就可以看见爸爸的鸡鸡了呢」
「ヘンなとこ擦ってて、んんっ！」	「在奇怪的地方摩擦着...嗯嗯♥」
「ちょ、ちょっと待っててね」	「啊...稍微等等...」
「ちゃんとごほーしするけど、刺激が強すぎて、ちょっと……」	「呜啊...刺激好强的感觉，至少...至少温柔一点呀...」
「ひゃぁぁぁんっ！　少し動いただけなのにぃ……」	「嗯啊啊~~明明...明明只是稍微动了一下而已...」
「うっ……ぐ、うぅぅぅっ……」	「嗯...唔啊啊...」
「こ、こっちだと、余計にヘンなところで擦れて……」	「这...这样的话，就会摩擦到奇怪的地方...」
「ご、ごめんね、とーさま」	「对，对不起，爸爸...」
「ボク、この体位じゃまだ」	「是...是不大适应这个体位啦...」
「とーさまを気持ちよくしてあげられないみたい……」	「好像...做不到让爸爸也舒服起来什么的...呜...」
「とーさまが望むなら、そりゃ勿論」	「如果是爸爸希望的话，那当然可以」
「でも、でもさぁ……」	「但是，但是...」
「そんな変なものに頼らなくたって……」	「不要老是依赖那种奇怪的东西啦...」
「え、なに。このブルブル震えるヘンなもの」	「啊...哎？这抖动着的，奇怪的东西...」
「……これをアソコに？」	「要把这个放在那里...？」
「とーさま、せめて自分の手でりょーじょくしようよ……」	「爸爸...至少亲自用手来吧...」
「……早く済ませて」	「...索性，快点结束吧」
「そりゃ、それでだってボクは乱れるよ」	「啊啊...甚至因为这种东西起了感觉」
「エッチな声を上げて、アソコをおつゆまみれにしちゃうよ？」	「发出了色情的声音，甚至连爱液都流出来了...」
「でもさ、でもさ……とーさまの、ばかぁ……」	「但是，但...呜...笨蛋爸爸」
「んー。そーゆー機械？　みたいなのより、さ」	「嗯...就用这种机器吗...？而不是什么类似的东西...」
「ボクとしては、とーさまの指で」	「对比起它还不如用爸爸的手指呢...」
「乱れさせて欲しいけどなぁ……」	「虽然也希望能让爸爸也变得奇怪起来呀...」
「ねぇ、とーさま。ふつーに濡らすのじゃダメなの？」	「唔，爸爸。用手来慢慢弄湿我不行嘛？」
「とーさまにじゅーりんされる過程がすっ飛ばされるのは、寂しいな」	「被爸爸爱抚的过程什么的就这样被省略掉了，不开心...」
「こーゆー道具に頼らず、ふつーに濡らしてほしいけどなぁ」	「不要这么依赖那些道具，就这样正常的弄湿我不好嘛」
「とーさま、案外残念なヒト？」	「爸爸...真是让人失望呢」
「……ま、ぬるぬるぐちょぐちょの潤滑液プレイってやつだと思えば」	「...姆，如果爸爸把自己的动作稍微放慢一点点的话...」
「そこまで嫌じゃないよ。とーさまのしてくれることだし、ね」	「也就没那么讨厌了啦。爸爸肯定是会为我这么做的对吧，呐？」
「えー、またコレ？」	「哎，又是这个？」
「組み敷いて愛撫で濡らしてはくれないの？」	「就不能用正常的爱抚来弄湿我嘛...」
「とーさまが望むなら、毒だって何だって飲むけどさ」	「如果爸爸希望的话，就算是毒药的话我也会毫不犹豫地喝下的」
「どうせなら、とーさまの手で乱れさせて欲しかったなぁ」	「反正，想要用爸爸的手来弄得兴奋起来啊...」
「えっと、とーさま。要するに自分の手管に自信がないってこと？」	「嗯...爸爸是对自己的技术没有相应的自信吗？」
「……とーさまのばか」	「...笨蛋爸爸」
「おくすりなんて使わなくたって、ボクはとーさまの為なら、どれだけだって乱れられるのに……」	「就算不用那些药，只要是为了父亲大人的话...不管怎样都肯定会被弄湿的」
「とーさま。こんなのに頼ってばっかじゃ馬鹿にされるよ？」	「爸爸，总是依赖这些药的话可是会被当成傻瓜的哦？」
「え゛、いや。ちょっと待って。それはエッチじゃないって……」	「哎，不，等等...这种事情绝对也不是H的范畴了吧...」
「やっ！　痛～～～～～！　痛い、痛いって！」	「呀啊~~好痛！好痛啊！」
「とーさまのばかぁ……そんなの絶対おかしいよ……」	「笨蛋爸爸...这种事情绝对很奇怪吧...」
「いや、いやいやいや。とーさま、ちょっとタンマ！」	「不，不要，爸爸，等一下！」
もともと怪しい時代背景をも無視して作った圧力釜。それによる高圧高温滅菌の施された3寸針を手に取ると、	无视了放在旁边那台明显完全不属于目前时代的高压锅，当%CALLNAME:MASTER%拿起旁边那闪着寒光的三寸长针时
%CALLNAME%は冷や汗を垂らして首を振る	一直用恐惧的视线望着这边的%CALLNAME%就不禁滴着冷汗摇起了头
「とーさま、それはおかしいって。絶対、それは気持ちよくない。ごーもんの一種……」	「爸爸，这种事情也太奇怪了...正常人都绝対不会因为这种事情舒服的吧...」
「え？　その手のことも快楽にしてやるって？」	「诶？你说...这种事情也是可以让你开心的吗？」
「うーん。とーさま相手ならそんな方向性も……いや、やっぱりちょっと待っ……」	「嗯...如果如果爸爸就是想要这样的话...不，还是等...」
「～～～っっっ！！！」	「~~~~？！！」
ぐずる実娘の乳首を金属棒で貫けば、声にもならぬ悲鳴と共に幼女の身体が弓なりに沿った	就这样用钢针缓缓地贯穿了亲女儿的乳头，伴随着痛苦到无力发出声响的悲鸣，幼女猛然紧绷的身形不住地颤抖着
「か―――はっ……。とーさま、これは……ちょっと……」	「啊————啊...爸爸，这种事情...」
潤んだ目で、恨みがましげにこちらを見る%CALLNAME%。どうやらまだまだ調教の必要がありそうだ	感受着%CALLNAME%那湿润的眼睛里夹带着少许恨意的目光。看来还是得对她更多做些调教才行...
「とーさま。これ、ボクがいやだって言ってもやるんだよね？」	「爸爸...这种事情，即使我说了不愿意的话，也还是会这么做吧？」
「ボクが悲鳴を上げても、泣いちゃっても、痛みでのたうっても」	「即使我发出悲鸣，哭泣，还有痛苦的呻吟」
「続けちゃうんだよね？　ボクの大事なところ、その冷たいやつで刺しちゃうんだよね？」	「也一样是会继续下去的吧？还是会用这些冰冷的家伙，插进我重要的地方的吧？」
そう口にする%CALLNAME%の表情には痛みや損壊への恐怖と、僅かな期待が含まれている	这般说着的%CALLNAME%的表情中，夹带着对痛楚和损坏的恐惧，然而在她的眼目深处，却也含着一丝对于下一步行动的期待
「そうだよね、仕方ないよね。とーさまがやるって言ってるんだから」	「是啊，没办法啊。因为爸爸说要这么做...」
「ボクにはどうすることもできないんだよね？」	「反正我肯定是无能为力的，对吧？」
まるで抵抗しないことへの言い訳を探しているような%CALLNAME%	%CALLNAME%轻声说着，仿佛在寻找着对于不可抗力的借口
その乳首と秘芯は、愛撫ではない別の何かを待ち望むかのように充血し、	然而她的乳头与花核，却又好像是在期待着另一个东西，而不是爱抚
はちきれんばかりに震えている	颤抖得好像是要裂开似的
「はっ……あ、ぎ……痛っ……あ、あ゛あ゛あ゛あ゛あ゛っ！！」	「哈...啊...好疼，啊啊...！」
両乳首と、クリトリス。神経の集中した三つの部位へと金属針が突き刺さり	上半身的两颗乳头，下半身的小巧阴蒂，金属针就这么刺入了她神经最为集中的三个部位
%CALLNAME%は悲鳴とも絶叫ともつかぬ声を上げて痛みに耐える	纵使%CALLNAME%大声地惨叫着，都无法缓解她所受到的那些痛苦
しかしその淫唇からは新たな愛液があふれ、頬は紅潮している	可是此时，在她的淫唇却又溢出了新的爱液，同时脸颊也泛起了大片的潮红
悲鳴から、甘い何かが見え隠れするのは気のせいではあるまい	纵使%CALLNAME:TARGET%正在悲鸣着，可%CALLNAME:MASTER%却在她身下隐约看见了渗出的淫蜜...那肯定不是心理作用吧
%CALLNAME%は既に、痛みさえも快楽となすところまで開発されているのだ	%CALLNAME%已经开发到甚至会因为痛苦而感受到快感的地步了
「とーさまのバカ、抖Ｓ！」	「笨蛋爸爸，抖S！」
「悪魔、鬼畜外道！　えっと他には、って……ひっ、あっ……ぎっ……」	「恶魔，鬼畜外道！还有...啊！啊呀...啊...」
充血し、愛撫を待ち望む乳首へと、冷たい金属針が突き刺さる感覚に、	渴望爱抚的乳头因充血而勃起，然而从其上方传向%CALLNAME%的脑海的却是钢针插入其中的剧痛感
%CALLNAME%は悪態をつく余裕もなく悲鳴をかみ殺す	%CALLNAME%没有骂人的余地，只能咬紧牙关以使自己不致失态地悲鸣起来
「こ、これが気持ちよくなるってありえないよ。とーさまのばかぁ……」	「这...这种事情怎么可能会舒服起来嘛...笨蛋爸爸...」
「いーけど。どうせなら、とーさまにして欲しいなぁ」	「虽然这样也的确...但还是更想要父亲大人来啊...」
「とーさまの、ヘンタイ」	「爸爸可真是个奇怪的家伙...」
「そりゃ見たいってなら、見せたげるけど」	「既然想看的话，那就给你看吧...」
「んっ……あっ……。ねぇ、とーさま。見ててくれてる？」	「嗯...啊...爸爸，在看着我吗？」
「ボクのここ、もうこんなになってる。とーさまのが欲しくて、びくびく震えてるんだよ……」	「我的小穴...已经变成这种样子了哦...好想要爸爸的肉棒插进来，就像之前那样，咕啾咕啾地搅动着里面啊...」
「んっ……はっ……あっ……。ねぇ、とーさま。こんなの見てて、楽しいの？」	「嗯...哈...啊...父亲大人，看着人家自慰什么的，很开心吗...？」
「い、いや。とーさま、それナニ？」	「呜...呜啊，爸爸，这是什么啊...？」
妖術によって%CALLNAME:MASTER%の身体から這い出ていた触手を前に、 %CALLNAME%の表情がひきつる	在被妖术从%CALLNAME:MASTER%的身体爬出的触手面前，%CALLNAME%的表情被吸引了
「え、それもとーさまの身体の一部？　とーさま、人間だよね！？」	「诶...那，那也是爸爸身体的一部分？爸爸你...是人类吧！？」
%CALLNAME:MASTER%が人間でないなら、%CALLNAME%は一体なんだというのか	如果%CALLNAME:MASTER%不是人类，那么%CALLNAME%又是什么？
そう問われて困り果てる%CALLNAME%へと、粘液でてら光る軟体の群れが殺到する	被这样问得一筹莫展的%CALLNAME%，被遍布着黏液而反着光亮的，蜂拥而至的触手群淹没了
「わー、ちょっとタンマ！」	「哇啊...等，等等！」
「流石に初めてくらいふつーに奪ってくれたっていいじゃないか！　ばかぁ！」	「难...难道用正常的方式夺走人家的第一次不好嘛！笨蛋爸爸！」
「いくらとーさまの一部だって言われても、さすがにそれは心の準備が……」	「不管怎么说，就算被告诉这些的确也是爸爸身体的一部分，但心理上也还是...」
うぞうぞと己の周りで蠢く触手的群れに、%CALLNAME%は落ち着かな気に身を震わせる	在正围绕着自身蠕动的触手群中，因恐惧而颤抖着的%CALLNAME%努力试图平稳着呼吸
「ね、ねぇとーさま。やっぱボク、とーさまの手でシて欲しいなぁって……」	「呐，呐...爸爸，果然，我还是更想要你用自己的手来...」
「あ、やっぱダメなのね」	「啊...果然还是不行吗...」
「そりゃさ、とーさまの求めには最大限応えたげたいけど、これは……」	「虽然想最大限度地满足爸爸的需求，但这种事情还是...」
「んっ……、もう……こんなことばっかりするんだから……」	「嗯...爸爸老是做这种事...」
%CALLNAME%は己が肌の上を這いずる%CALLNAME:MASTER%の触手に身を任せながら	%CALLNAME%任由%CALLNAME:MASTER%的触手在自己的肌肤上蠕行着
不満そうに口を尖らせる	同时不满地噘起嘴来
「ま、まぁ……ひゃぅっ……とーさまが……したいならいいけどさ……んっ」	「嘛，嘛...如果是爸爸想做的话，那当然可以...哼嗯...」
「やっぱりボクとしては、とーさまの五体で凌辱して……あうぅっ！　……ほしいかなぁ」	「果然，作为我来说，还是更想要全身都被爸爸凌辱什么的...呜啊~！哈...好想要啊...」
とはいえ、%CALLNAME%は繰り言を口にしながらも、触手的愛撫に抵抗しようとはしないのだが	虽然%CALLNAME%的嘴上是这么说着，但她实际上却根本没有做些什么抵抗触手的行动
「あ、あ、あぅ……ひゃんっ♪　もぉ……とーさまコレでばっかり苛めないでよ……」	「啊~哈...姆~啊啊~~不要老是...用这种东西来欺负我呀...」
触手に吊るされ、粘液に包まれたそれに全身を愛撫されながら、 %CALLNAME%が恨みがましげに%CALLNAME:MASTER%を睨み付ける	被触手悬吊起来，全身都被黏滑液体包裹着的%CALLNAME%不满地盯着%CALLNAME:MASTER%
とはいえその頬は上気し、瞳は与えれる悦楽に潤み、喉を震わす音は半ば嬌声。言葉に不能場合さえある	然而，她脸上的表情却显得像是很开心般的样子———眼睛因触手带来的快乐而被濡湿，喉咙也在刺激下不时溢出着娇声
「こ、これもとーさまの一部だっていうなら、不満は……あ、あっ　ないけど……さ……んっ……」	「如...如果说这些也是“爸爸的一部分”的话，是不会……有什么不满啊啊♥，不满的啊~♥哈啊...嗯...」
「なんかボク、想定外の方向でエッチにされてるっていうか……きゃぅっ！　と、とーさま待って、そこは……」	「真是的，被以意料之外的方式侵犯了...啊呀...！等等，那里是...」
胸の周りを、乳首を、秘貝を、ぷっくりと膨らんだ淫核を、或いは菊門を	乳房周边，乳头，秘贝，因发情而勃起的阴蒂，以及菊穴
個別に、或いは同時に愛撫され%CALLNAME%は形ばかりの抗議さえ嬌声に変え、身を震わせる	个别的，或者同时的被爱抚的%CALLNAME%连形式上的抗议也变成了娇声，浑身都在颤抖着
もはや%CALLNAME%の中に己の身を這いずる触手に対する嫌悪感はない	%CALLNAME%对在自己身上爬行着的触手已经没有了丝毫的厌恶感
より深い異形の悦楽へと%CALLNAME:MASTER%の愛娘を導くことも、そう難しいことではないだろう	将%CALLNAME:MASTER%的爱女引导着去领悟到更深的异常的喜悦，恐怕也已经不是那么困难的事情了吧
「と、とーさま？　なんだか、狙ってるところが微妙におかし……やっ……そこっ……」	「爸...爸爸？总觉得，那些触手盯着的地方有点奇怪...哎，那里...？」
%CALLNAME%の身体を這いまわる触手的いくたりかが更に微細な触毛へと枝分かれし、	在%CALLNAME%的身上蠕行与攀爬着的触手逐渐伸展开一些更加细小的分杈
%CALLNAME:MASTER%の眷属の各所へと殺到する	随后便涌向了%CALLNAME:MASTER%女儿身体的各处
乳房へと巻き付いたものの先端は、硬くしこった乳首へととぐろを巻き、	尺寸较大的触手缠绕在乳房前的尖端，而那些细小的则是绞住了她那因发情而勃起的乳头顶上
その先端から乳腺へと繊毛を侵入させる	那些纤细宛如头发丝般的触手就这般从乳孔涌入，插入了乳腺
尻穴へと挿入されたものは腸壁の襞の一つ一つを撫ぜ回すように分裂させた触毛を蠢かせ	而插在尻穴中的触手，此时也在延伸着细小分杈，去仔细爱抚着肠道中的各个褶皱
充血した秘芯の下、尿道さえも微細な淫肢の侵入は免れえない	在那充血而勃起的淫核下，就连尿道都都没能幸免被细小触手入侵的命运
「はっ……ひゃっ……んぅ……あっ……これ、変だよ……変なのに気持ちよく……やっ……やぁぁぁ……」	「哈...啊呀，嗯...啊啊~这...这也太奇怪了...但是，明明都觉得很奇怪，但身体却又这么舒服~~哈...呀...」
経験したことのない異形の快楽に、%CALLNAME%は戸惑いながらも、身を任せていく	对于从未经历过的异常快感，%CALLNAME%虽然困惑，但是出于对她父亲大人的信任，还是主动将身体交出任由侵犯
「うぅぅ……。とーさま好みのヘンタイさんになれるのはいいけど、さ」	「呜啊...能够成为父亲大人喜欢的样子虽然很棒，但...」
「なんかほとんど人体改造っぽい開発のされ方してる気がするよ……」	「被这样开发着什么的...感觉就好像是被进行了什么人体改造一样呢...」
「あぅ……んっ……ふぁぁっ、ひゃうっっっ♪」	「啊...嗯...呜啊啊~~♥」
胸や膣、陰芯や菊門のみならず	胸部与淫核，膣道与屁穴
尿道、乳腺、臍など異様な場所まで触手に犯され、嬌声を上げる%CALLNAME%	甚至是尿道，乳腺，与肚脐这些异常的地方都被触手侵犯着
半ば人外の快楽におぼれる%CALLNAME:MASTER%の娘だったが、	已然有些沉溺于人外快乐的%CALLNAME:MASTER%的女儿，在快感下肆意地发出着娇声
流石に己の耳朶へと触手が殺到すれば、僅かに怯えの表情を見せ、抗議の声を上げる	但在触手蜂拥到自己耳朵周边时，%CALLNAME%还是露出了微弱的胆怯神情，发出了抗议的声音
「ちょ、たんま、タンマ！　それは絶対おかしいって！　そこは入れるところじゃ……」	「等...等等啊，插入这里什么的...绝对很奇怪...」
「ひゃぁぁぁんっ！　や、やだ。なにこれ……耳の中でぐじゅぐじゅって……ひんっ！」	「啊啊~~不，好讨厌...等等，这是什么...哈啊，在耳朵里也咕啾咕啾的...啊啊...」
粘液に包まれた細い触手が己の耳の中を這いずることで与えられる異様な感覚に	被粘液包裹着的细小触手在耳朵中爬行的动作给予着%CALLNAME%异样的感觉
%CALLNAME%は戸惑いながらも身を震わせる	%CALLNAME%一边困惑于此，一边颤抖着身体
「とーさま、ダメ……エッチな音が、耳に残っちゃう！　ずっと頭に犯されてる音が残っちゃう！」	「爸爸，不要啊...耳朵那里，全部都是色情的声音，就这样一直进行下去的话...简直脑袋都要被这种声音给侵犯了...！」
「こんなことされたら、普段からエッチなことしか頭にない、ヘンタイさんになっちゃうよ……」	「要是再继续这样下去的话，平时脑袋里都会满是色色的事情...会变成变态的...」
「はっ、ひゃんっ……や、やぁぁぁ。そこ、ぞくぞくって……」	「哈，呀啊...在那里，一个劲地...」
背筋を震わせ、異形の快楽に相好を崩す%CALLNAME%	从脊椎向着全身传递着颤抖的信号，%CALLNAME%的理智都好像要被这异形的快乐摧毁般
その形の良い耳には幾本もの極細の触手が潜り込み、	形状优美的耳朵中，缓缓地滑入了数根极细小的触手
媚薬となる粘液を滴らせつつ、耳介や外耳どころか	而在它们逐渐渗出与滴落着媚药的黏液时，别说是耳廓与外耳
異界の理でもって鼓膜さえすり抜け、中耳や蝸牛にさえ愛撫を施していく	就算是鼓膜也被缓慢地穿过了，连内部的中耳与耳蜗也被施与着爱抚
「あっ、なんかふわふわって……これ……なんで……」	「呜啊...感...感觉浑身都轻飘飘的，为什么...」
蝸牛の奥、卵形嚢など、バランスや重力感覚を司る場所を触手に嬲られ	耳蜗内部，以及卵形囊等，掌管平衡和重力感觉的地方也被触手肆意地奸淫着
%CALLNAME:MASTER%の実娘は不安や恐怖を内包した悦楽に体をくねらせる	%CALLNAME:MASTER%的女儿身体因对她身体包裹而上的不安与恐怖，以及强烈的喜悦而扭曲着
「こ、これ。おかしーよ。こんな気持ちよさ教えられたら」	「这种事情...好奇怪啊，但我甚至不太好描述什么的，总之...好舒服的感觉，哈啊....」
「戻れなくなっちゃう。とーさまに犯してもらわないとダメな娘になっちゃう……」	「已经彻底回不去了...变成了如果不被爸爸侵犯的话就会变成废人的女儿...」
「ひっ、あっ、はっ……は、ひゃぅっ……」	「呜啊，哈...啊啊...」
常であれば整い、凛とし、清涼な雰囲気さえ纏ったた%CALLNAME%の表情が、	%CALLNAME%的表情一向整洁凛然，甚至会给人带来种冷酷的感觉
普段接する兵士たちが大よそ想像すべくもない、淫悦に傾倒したしどけないものへと崩れる	她平素所接触的士兵们一定是无法想象的吧，这样一位朝气蓬勃的少女会向着淫悦倾倒，露出如此色情的姿态
%CALLNAME%の全身に巻き付き、あらゆる場所を愛撫する%CALLNAME:MASTER%の触手は当然のように	缠绕着%CALLNAME%的全身的，来自于%CALLNAME:MASTER%的触手正一如既往地爱抚着它们所能够接触到的所有地方
%CALLNAME%の耳の中にまで入り込み、文字通りの意味で少女の最奥までをも犯していく	这次也理所当然地进入到了%CALLNAME%的耳朵里，字面意义地侵犯着少女身体的最深处
「と、とーさまぁ……とーしゃまぁぁぁぁぁ……」	「父...父亲大...大人啊啊啊...」
半ば崩れたかのような声音で%CALLNAME%が%CALLNAME:MASTER%を呼ぶのも必定であった	%CALLNAME%以脆弱到仿佛自己随时都会如瓷娃娃般破碎掉那样的声音呼唤着%CALLNAME:MASTER%
なんとなれば、%CALLNAME%を侵す触手的一部は少女の鼓膜を浸透し、	不管怎样，此时侵犯着%CALLNAME%的触手，已然是部分的渗透了少女的鼓膜
媚薬粘液をたっぷりと塗りつけながら中耳を通り抜け、	一边朝着所能接触到的地方涂抹着媚药黏液，一边缓缓地穿过中耳
蝸牛神経にまとわりつきながら脳にまで浸食しているのだから	在耳蜗的神经上缠绕着的同时，一边侵蚀到了她的大脑
「と、とーしゃまぁ……駄目、ダメだよ」	「然后...不...不要啊...♥」
「そこはダメ、ほんとに戻れなくなっちゃう」	「如果侵犯到那里的话...就真的回不去了...」
「ボク……ボクの意識までとーさまのもので犯されて、とーさまのことしか考えられなくなっちゃう」	「我...就连我的意识都被父亲大人给侵犯了啊...脑子里就会除了父亲大人什么都想不到了...」
「それじゃダメだよ。ボク、そこまでおかしくされちゃうと、とーさまの役に立てなくなっちゃう」	「那种事情可不要啊...如果侵犯到这种地步的话，我对父亲大人就再也没有任何用处了吧...？」
己の精神を物理的に犯されてなお、自身のことでなく%CALLNAME:MASTER%のことを考える%CALLNAME%	%CALLNAME%优先考虑着%CALLNAME:MASTER%而不是自己，即使是在被物理上彻底侵犯了整个精神以后也依旧如此
健気な実娘に、%CALLNAME:MASTER%の都合の良いよう%CALLNAME%の脳を書き換えるだけだと告げれば	于是%CALLNAME:MASTER%决定这么告诉%CALLNAME%———只需要一定程度上的改写她的大脑，以适应%CALLNAME:MASTER%的方便
%CALLNAME:MASTER%の血を分けた少女は、にへらと笑って体の力を抜いた	于是接下来身为%CALLNAME:MASTER%的分血的少女，就微笑着放松开了身体
「あ、なんだ。そーなんだ」	「啊...只是这种程度的话」
「なら、いーや。とーさま。ボクを作り変えて」	「那么就请吧，爸爸，随您所想地改变我吧」
「とーさまの都合の良いように。とーさまが望むように」	「正如爸爸所期望的那样，变得更加方便什么的...」
「僕の身体を、僕の精神を」	「我的身体，我的精神」
「とーさまが目論むえっちな娘になれるように、好き勝手に、弄り倒してほしいな♪」	「为了成为让父亲大人能够随心所欲地玩弄着的淫荡女儿...~♥」
最早%CALLNAME%の身体で、%CALLNAME:MASTER%の触手が蹂躙していない場所はない	%CALLNAME%的身体上，已经没有未被%CALLNAME:MASTER%的触手蹂躏的地方了
胸を、秘所を、乳首を、秘芯を、口を、舌を、耳を、尿道を	口腔，舌头，胸部，乳头，秘所，耳朵，尿道
或いは腸壁を、子宮を、卵管を、蝸牛を、	甚至是肠壁，子宫，输卵管，以及耳蜗
心臓、神経系、脳さえも	心脏，神经系统，乃至于大脑
%CALLNAME:MASTER%の生やした粘液を滴らせる異形の器官が這いまわり	都在被不住淌流着%CALLNAME:MASTER%的黏液的异形触手所攀附着，并在这些地方重复着蠕行与攀爬的动作
性的なそれとはとても言えぬ悍ましい振る舞いでもって	%CALLNAME:MASTER%就以这种令人恐惧以至于根本无法称之为性行为的方式
%CALLNAME:MASTER%の実娘を凌辱していく	凌辱着自己的亲生女儿
しかし全身を、その内部さえも犯される%CALLNAME%の表情に嫌悪はない	可是———全身，就连身体内部也被侵犯的%CALLNAME%的表情，却丝毫没有什么厌恶感
蕩けたそのかんばせにあるのはただ	即使是未曾联想到那已然毁坏的伦理观，此时此刻能够从她的表情中所看见的也只有———
より深く%CALLNAME:MASTER%のものになれることへの悦び	对更深沉地堕落于%CALLNAME:MASTER%手中的喜悦
%CALLNAME:MASTER%のために自らが在れることへの歓喜	对于自己成为了只为%CALLNAME:MASTER%服务而存在的肉玩具的事实而欢喜
ただそれだけである	在她的脸上所能看到的，就只有这些了
「とーさま。だいすき、だいすき、大好き」	「爸爸...我...我最喜欢你了」
「とーさま、ボクを好きにして」	「爸爸，也同样的给予我更多的爱吧」
「壊したっていい、狂ったっていい」	「就算是将我摧毁也好，即使是就这样使我彻底疯狂也没有关系」
「大丈夫。死んじゃったって、魂だけで」	「没关系...就算死了，我的灵魂———」
「とーさまのそばに、ずっとずっといてあげる」	「也会永远陪伴在父亲大人身边」
「だからとーさま。ボクをとーさまのものにして」	「所以说啊...就这样把我变成父亲大人的东西吧」
「とーさまだけのものに、とーさましかいらないものに」	「只属于爸爸，也只需要爸爸的东西」
「ボクをちょーきょーして……」	「就这样，再推着我走下最后一步...让我彻底堕落在淫欲的深渊里吧...」
「は、ひゃっ……ひぅっ……ひっ、あっ……は、あぁぁぁぁっ！」	「嗯...唔啊...哈啊啊...~~~」
通常の性感帯は勿論、乳首の内側へと、尿道の内部へと、臍の奥へと	对通常性感带正在进行着的各种爱抚已然可以抛开不论了。此时此刻，即使是乳头内侧，尿道内部，以及肚脐的深处
細微な触手が分け入り、愛撫を繰り返す中	都被大群细小的触手们分了开来，反复地爱抚着
%CALLNAME%は当然のように抵抗することなく、異形の愛撫を受け入れ、身を震わせる	%CALLNAME%丝毫没有进行无意义的抵抗，就这般接受着异形触手的爱抚，浑身颤抖
それは少女の耳をを伝い、更に細分化された触手が脳へと殺到しても同様であった	即使那些正插入少女耳朵的那些更加精密的触手已然涌入到了她脑中，也同样是如此
「あっ、あはは……。うん、わかるよ　とーさま」	「啊~哈啊,,,嗯，我明白了，父亲大人」
「ボクがどうなればいいのか。んっ……」	「以后...我又该怎么办什么的...嗯...」
「とーさまがボクをどうしたい……の、か……ひゃぅっ！」	「爸爸想把我变成怎么样...的，或者...呀啊~~」
「ひぅっ……あ、あっ……よりエッチで……んっ！」	「唔...啊，啊...更加H...什么的~啊啊...！」
「よりとーさまに都合のいい、とーさまのモノになるのにどうすればいいのか」	「为了成为对父亲大人更加方便的玩具什么的...」
「うん、すごく、すごく分かるよ……あうっ！」	「嗯，非常，非常明白哟……啊！」
媚薬粘液を滴らせる極細微な触手が、%CALLNAME%の精神を物理的に犯す中	不住滴落着媚药体液的触手，正在物理意义上的侵犯着%CALLNAME%的精神
%CALLNAME:MASTER%の血族は抵抗することなく、	然而，%CALLNAME%却并未抵抗
それどころか己の心を書き換えられることを喜んで受け入れていく	相反，她很高兴地接受了自己思想能够被父亲大人任意复写的事实
本来ならば発狂どころでは済まない外道の処置も	本来那些甚至会将人侵犯到发狂的外道之事
最早%CALLNAME%にとっては%CALLNAME:MASTER%への想いを示す愛情表現の一つにすぎない	此时此刻对于%CALLNAME%来说，也不过是展示对%CALLNAME:MASTER%的感情的爱情表现之一
「ふふっ……実娘を懸想させ、犯し、とーさま専用のエッチな人形にしても」	「呼呼...就算是连思想也彻底侵犯了...身为女儿的我就这样沦为了父亲大人所专用的肉玩具呐...」
「とーさま的にはまだ足りないんでしょ？」	「不过啊...即使是这样，也还不够吧？」
「まだ先が、とーさまがボクをモノにするための果てがあるんでしょ？」	「还有将来，为了父亲大人，我还有很长的路要走...对吧？」
「ここまでしても、まだ不安なんでしょ？　ボクがどこかに行かないか」	「即使已经亲密到了这种程度...我还是很不安呐，被父亲大人送到什么遥远的地方去什么的...」
「とーさまに愛想を尽かさないか、怖いんでしょ？」	「好害怕呐...和爸爸的感情永远消失什么的...」
「嬉しいよ、とーさま」	「不过至少现在...我很开心哦，爸爸」
「とーさまが未だなお、ボクをじゅーりんしたいって、まだとーさまのものにしたりないっていうなら」	「如果父亲大人还想把我变成自己的东西的话...」
「ボクはどこまでだって、とーさまのものになってあげる」	「不管到哪里，只要父亲大人来了，我都会很快的重新进入到肉便器的角色里...」
「どこまでだって、捧げてあげる」	「将身心都悉数奉上」
「ボクはいつだってとーさまのもので、とーさまのもとにあるんだって」	「无论是在什么时间，什么地点...我都永远是爸爸的所有物」
「ボクの最愛の人に、ずっとずっと、証明してあげる」	「我会永远向我所爱的人证明这一点」
「んっ……とーさまのすることだもの。嫌とは言わないけどさ」	「嗯...爸爸就是这么做的，虽然人家不算是讨厌它...」
「ちょっと、不安だな……」	「但还是有些不安呢...」
「とーさまのことだもの」	「不过嘛...爸爸的话」
「きっとこんな不安も、割とすぐ払拭してくれるんだよね？」	「我相信这种不安很快就会消散的，对吧？」
「もー、とーさまのバカ」	「啊啊~爸爸真是个笨蛋...」
「……そりゃ、さ。ちゃんと段々気持ちよくなれるようにしてくれてるのは分かるんだ」	「...啊呀，是这样呢。我感觉得到，爸爸正在逐渐让我舒服起来...」
「でも……やっぱこのうにょうにょの外見は……って！」	「但是...果然这样看上去什么的...还是...！」
「んにゃぁぁぁぁっ！　と、とーさま！　せめて台詞を最後まで言わせ……んぁぅぅぅぅぅっ～～～！」	「呜啊啊~~~爸...爸爸！至少把我把这些话说完...嗯啊啊啊~~~~♥♥」
「……できれば、とーさまに触ってほしいんだけどなぁ」	「...如果可以的话，还是希望爸爸能来摸摸我呢」
「んっ　ちょっと、慣れてきた……かも……」	「嗯，对这种事情也有点习惯了...或许...」
「うぅ……やっぱり気持ち悪いよ……」	「唔...果然很恶心啊...」
「え、お話？　いーよ、何話そうか？」	「诶...想和人家说话吗？那...要说什么好呢？」
「ねぇねぇとーさま。きょうね、きょうね……」	「喂，爸爸。今天啊...」
%CALLNAME%は頬を紅潮させ、他愛のない日常の出来事を話している	%CALLNAME%脸颊泛红，讲述着日常的琐事...
「ん、んん？　えぇ？　とーさま、ほんとにそんなことあったの？」	「哎...哎哎？爸爸，真的有发生过那种事情吗？」
%CALLNAME%は突拍子もない噂話を告げられ、目を白黒させている	被告知了一个突如其来的传闻的%CALLNAME%不由得瞪大了眼睛...
「そーいや、例の武将の奥さん、痴情の縺れで……」	「啊呀...那个武将的太太，因为感情的纠纷...」
世のご婦人方は色恋沙汰に興味津々であり、%CALLNAME%もまたその例に漏れ……	世上的妇女们几乎都对那些爱情故事非常感兴趣，就连%CALLNAME%也不例外...
「で、刃傷沙汰になったみたいなんだけど。その時の構えがさぁ……」	「然后，就好像变成了刀伤事件。当时的场面嘛...」
……漏れ、漏れず……	...稍微流下了几滴冷汗
「ん？　どーしたの、とーさま。武術の話はいやだった？」	「嗯？怎么啦，爸爸？不喜欢武术相关的话题吗？」
ああ、うん。どうだろうね	啊，嗯...点了点头
「とーさまだって一角の武将だもの」	「爸爸也是一位武将嘛」
「囲う女の子をボクだけにしろ、なんて言わないけどさ」	「虽然我不会说什么这辈子都只能有我一个女孩子什么的」
「ボクのこと”も”、大切にしてね」	「但也请好好地珍惜我哦？」
いつも通りの天真爛漫な笑顔でそう告げる%CALLNAME%	%CALLNAME%带着像往常一样天真烂漫的笑脸这么说着
しかしその瞳の奥に、僅かな寂寥感が揺らめいているのは気のせいではないだろう	但在那双眼睛的深处，却明显可察觉到有着些许寂寥感在其中摇曳着...肯定不是心理作用吧
―――――まあ、だからと言って他の娘に手を出さないかといえば	―――――嘛，虽说如此，但这也并不意味着我就不会去碰其他女孩子了
それはまた別の話であるわけだが	那就是另一回事了...
「ふぅん、これがあっちの地方ので、これが西方の、その……”大陸”のもの？」	「嗯...这个是来自外界的...那一片广阔的世界的东西...？」
茶を饗する最中に披露した各地の風土や特有の飲み物についての話に	在给她端上一杯咖啡以后，我们谈到了那些来自各地方的风土人情，以及属于那些地方的特有饮品
%CALLNAME%は興味深そうに頷いている	%CALLNAME%兴致勃勃地点着头...
「世の中にはいろんな場所があるんだね」	「世界上有着各种各样的神奇的地方」
「いつかとーさまと訪れてみたいな」	「想要和爸爸一起去好好看看呢」
「そーいやとーさま。昨日町へ行った時にさ……」	「呐，呐...昨天我上街的时候...」
%CALLNAME%は溌剌と腕を振り回し、己の見た実に些細な情景を嬉しそうに知らせてくる	%CALLNAME%活泼地挥舞着自己的胳膊，向%CALLNAME:MASTER%开心地诉说着自己所看到的那些琐碎的情景
こと%CALLNAME%といる以上、話のタネに困るということは無さそうである	既然是%CALLNAME%的话，就不会为了找到话题而烦恼了
「どうすればとーさまみたいな人たらしになれるのかな」	「我该怎么做才能成为像父亲大人一样的人呢」
「当然のように実の娘まで誑かす手管って大概だと思うけど」	「我想，大概就是得等到，连自己的亲生女儿都可以理所当然的塑造到这种程度的...样子吧？」
%CALLNAME%は%CALLNAME:MASTER%の対人技術について興味津々の様子である	%CALLNAME%对%CALLNAME:MASTER%的对人技术似乎很感兴趣的样子...
うんうん、なるほどー、へー、そうなんだー……	嗯，原来如此。啊，原来是这样啊...
よくよく観察してみると、%CALLNAME%の相槌のバリエーションは実に少ない	仔细观察的话，就会发现%CALLNAME%随声附和的次数实在是少之又少
しかしタイミングや抑揚、所作、視線、発声の速度など	但是时机，抑扬顿挫，动作，视线，发声速度等
言葉以外の面であちらこちらに気を使っているように見受けられる	在语言以外，似乎到处都用心地在
簡潔に、こちらの言葉の要点を拾い上げ、対手の情感をくみ取って	尽可能地简洁，摘取着语言的要点，并汲取着对方的情感
見た目にそぐわぬ思考の発露、%CALLNAME%の聞き手としての巧みさが%CALLNAME:MASTER%の言葉を上手く引出し	流露着全然不符合外表的思考，作为听众的%CALLNAME%巧妙地引出着%CALLNAME:MASTER%的各种言语
渾沌とした思考の中から明快な何某かの結論が導き出されていく	并从混沌的思考中，迅速地导出着各种明快的结论
%CALLNAME%の、ほけっと、何も考えていないかのような能天気な表情の奥	除此以外，%CALLNAME%的表情仍然是无比轻松，仿佛什么都没有考虑那般
言葉よりもものを言うとの形容の典型のような双眸が	在那双比起言语还要更加会表达信息的典型的双眸之中
炯々と知性の煌きを秘めこちらを見据えている	强烈的知性光辉正在耀眼地闪烁着
「出世は重要だよね」	「成功是很重要的，对吧？」
「どれだけ優れた腹案があったって、それを実現できる権力が無いと」	「无论多么完美的计划，都总会有百密一疏」
「ただの画餅におわるんだから、さ」	「最终都只不过是画饼罢了」
「ふぅん、世の中には不思議な生き物がいっぱいいるんだね」	「呼，世界上有着很多不可思议的生物存在着」
「……で、食べたらおいしいのかな、それ」	「...然后，它们的味道，会很好吃吗？」
「少数での戦闘が上手くても戦術規模の戦いは覆せない」	「街头械斗的水平再高，也无法左右一场战术规模的战斗」
「戦術に長けていても、戦略規模の戦で無敵を誇るのは無理」	「即使擅长战术，要在战略规模的战争中做到无敌，也是不可能的事情」
「戦略規模の戦いで神算鬼謀を誇っても、政治で決着をつけられたら積む」	「即使在战略规模的战斗中以神谋鬼算而自豪，要在政治上做出决断的话也是困难的事情」
「だから最高の軍師より、最高の政略家を雇った方が国のためになると思う」	「所以，比起雇佣最好的军师，选择最好的政治家对国家是要更加有益的」
「戦争の前提条件を棋盤ごとひっくり返せるんだもの」	「毕竟啊，他们可是有着能够把战争的前提条件，这整张棋盘都彻底推翻掉的能力的嘛」
「……まあ勿論」	「...当然，事无绝对」
「英雄豪傑の一騎駆けで、何もかもが吹っ飛ばされる可能性は常にあるんだけどね」	「在英雄豪杰单枪匹马的一对一战斗中，文官也很少能够战胜力量强大的武官就是了」
「チャンバラよりはおつむを使った方がとーさまの役に立てると思うけど」	「我认为比起修习剑术，还是多练习头脑要更好一点」
「ボクより機転の利く輩なんて一杯いるからね」	「有很多人比我更加足智多谋」
「とーさまの役に立つためにも、もっと精進しないとなぁ」	「为了对父亲大人有用，我也得更加精进才行呢」
「ちゃんちゃんばらばらなら、ボクに任せて」	「需要快刀斩乱麻地解决一场战斗的话，就交给我吧」
「天下無双の豪傑は彼の飛将軍ではなく」	「我要让所有人知道...天下无双的豪杰这个名号」
「このボクなんだって万民に知らしめてやるんだから」	「从今以后，都只能属于我这一人！」
「頭を使うよりは、槍を振り回してる方が得意かな」	「比起动脑筋，我还是更加喜欢挥舞长枪这种事情呢」
「……ま、そっち方面にしたところで、上には上がいるわけだけど」	「...嘛，不过就算是在这个方面上，也肯定会有比我更强的家伙存在的吧？」
各国が擁する綺羅星の如き英雄豪傑を思い浮かべ、	想起各国所拥有的，宛如星辰般数之不尽的英雄豪杰
%CALLNAME%はため息をついている	%CALLNAME%轻声地叹息着
「平和になったら、一緒にあちこち旅するのもいいかもね？」	「如果幻想乡有朝一日能够和平下来的话，我们就这样一起到处旅行什么的，也是个不错的选择吧？」
「え、路銀？　適当に野党を狩ればいいんじゃないかな」	「诶，旅费？适当地打击一下在野党不就有了吗？」
%CALLNAME%は、平和な世界というものが今一想像できていないようだ	%CALLNAME%似乎无法想象一个和平的世界...
「美味しいごはんって、士気を保つのに良いものらしいね」	「美味的米饭，是保持士气的好东西」
「と、いうわけで。さしあたって、街に行かない？　美味しいお店ができたみたいだよ？」	「就是这样。现在不一起去街上吗？那边似乎开了家好吃的店呢」
%CALLNAME%はそう言って、%CALLNAME:MASTER%の腕に身を絡めてきた	%CALLNAME%这样说着，主动挽住了%CALLNAME:MASTER%的手臂
「隗より始めよとは言うけどさ」	「虽然都说所谓的请自隗始」
「色恋沙汰について、ボクがとーさまの隗だったらヤだな」	「但这句话如果放在男女关系上...如果我在父亲大人的眼里是郭隗的角色的话...不行，那可就太糟糕了！」
「最終的に焦点が当たるのは楽毅だし」	「不过反正最后的话，众人目光的焦点也会集中在乐毅身上...」
「いや、まあ。じゃあ楽毅でありたいかと言われても困るけどね」	「不，算了。如果你问我想不想成为这个乐毅什么的话，我也会很困扰的」
「先立たれた挙句のアレだし。そもそもボク、文才ないし」	「毕竟我本来就没有什么写作天分嘛」（译者语：典故出自千金市骨，或者查请自隗始也可以，我已经尽力把这段翻得通俗了）
「やっぱり武器ってさ」	「毕竟是常见的武器呢」
「それ単体の性能より、戦場にどれだけ転がってるかが重要だと思うの」	「比起对单的性能，我认为还是在战场上的表现要更加重要一点」
「武人が蛮用する以上、頻繁に折れたり砕けたりするものだし」	「因为考虑到它们会经常被武士们残酷地使用什么的，所以就肯定不会被频繁地折断或是粉碎之类的吧」
「そうなったときに周りの死体から回収できるってのは」	「这样的话，它们就可以被从周围的尸体旁边回收起来」
「すっごく有利な点だと思うんだ」	「我认为这会是一个很大的优势」
「間合いが広ければ先に攻撃できるし」	「一寸长，一寸强」
「相手が近づいて来るのをけん制することができるから、相手はボクを攻撃しにくい」	「因为可以起到牵制作用什么的，所以试图靠近的敌人肯定都很难攻击到我」
「自分が攻撃しやすく、相手が攻撃しにくい状況を作りやすいなら」	「自己的攻击更容易产生效果，而对方对此也都会难以招架什么的...」
「落ち着いて行動できるし、冷静ならば周りだって見えてくる」	「这样的话，就有助于拿着长枪的人冷静地行动什么的，而心态稳定的话也可以更多地观察周围的变化...」
「間合いって重要だと思うな。とーさまは、どう思う？」	「所以说啊，我觉得距离是很重要的，爸爸，你觉得呢？」
「人様の頭をぐちゃっとやるには」	「要把人的脑袋砸开花嘛」
「武器を重くするか、動きを早くするしかない」	「唯一的选择就是尽可能地使武器更加沉重，或者是加快行动速度什么的了」
「だから普通に竿状武器を振り回すより」	「所以比起简单的去挥舞竿状的武器」
「遠心力で加速できて、先端が重い金属塊の武器って」	「这种通过离心力加速，顶端是异常沉重的金属块的武器」
「すごく強いと思うな」	「我觉得，很强啊」
「突いて良し、斬って良し、払って良し」	「可以刺，可以斩，可以拂」
「やっぱ武器ってのは複数の用途に対応していないとね」	「毕竟啊，作为武器，是必须要能够兼容多种用途才可以的」
「……ま、重さの割に脆いのが問題なんだけどね」	「...嘛，问题是比起重量来说的话，它的结构比较脆弱，是个问题」
「近い相手には剣、ちょっと離れれば鞭」	「近者为剑，远者即鞭」
「極端に近い相手には絡め取った後一気に引けば、無数の刃がざりっと対手の肉を……」	「与极端接近的对手发生纠缠后，就直接一口气地拉开距离，鞭子上无数的刀刃就会粗暴地刺进对手的肉里，然后...」
「ん？　どーしたの、とーさま。顔色が悪いようだけど」	「嗯？怎么啦，爸爸？总感觉你的脸色似乎不太好的样子...」
%CALLNAME%の戦闘描写は少々生々しさが過剰のように思われる	%CALLNAME%的战斗描写未免会让人觉得有些太过生动了...
「ボクの武器についてるこの変な機関」	「在我的武器里所安装着的这个机关」
「武器に内蔵するより、もっと大きなの作って」	「比起打造成所谓的武器，倒不如做成什么更大的东西...」
「水車の代わりにでもした方がよさそうな気がするけどなぁ……」	「我觉得用它代替水车什么的话，会是个更好的选择吧...？」
「え、面白い話？　うーん……あ、そうだ」	「啊，有趣的故事吗？嗯...啊，对了」
「大通りの染物屋さんのとこの白い犬がね」	「大街上的染坊里，有一只白色的狗狗」
はいはい、尾も白い尾も白い	是的是的，尾巴是白色的尾巴是白色的
「あー、もう！　なんでオチを先に言っちゃうのさ！」	「啊，已经...喂！为什么要把笑点这么早的就解释出来嘛！」
「流言飛語の類はあまり好きじゃないな」	「说实话，我真的不喜欢那些流言蜚语」
「対岸の火事なら野次馬するのも悪くないけど」	「不过虽然要是只是隔岸观火的话，看看热闹也不是坏事...」
「うっかり飛び火したら大火傷だしね」	「但是如果火烧到自己身上，那可就难受了」
「”おやこのかいわ”ってなんかいいね。半分くらい、良く分かんないけど」	「“亲子会话”什么的真好啊。虽然爸爸说的有一半多都听不明白就是了...」
そう言って%CALLNAME%は神妙そうに話を聞いている	%CALLNAME%带着好奇的表情继续听着故事...
「とーさま、ご指導お願いします」	「爸爸，请您指导我」
%CALLNAME%は真剣なまなざしのままぺこりと頭を下げ、武器を構えた	%CALLNAME%带着认真的目光低下了头，并准备好了自己的武器
「大好きだよ、とーさま。だからボク、絶対ぜったい手は抜かない」	「最喜欢你了，爸爸。所以我是绝对不会放弃你的」
「いくさ場でとーさまに死んでほしくないから。ここでは全力でいくね」	「我不想让爸爸在战争中死去。所以，我会在这里全力以赴」
「うん、またとーさまにじゅーりんしてもらわなきゃいけないから」	「嗯，我还希望爸爸以后能更多地陪我玩呢」
「せんそーで死なないように強く不能とね」	「为了不致于战死沙场，要让自己变得更强」
そう言った%CALLNAME%は真剣なまなざしで剣を構えている	那样说的%CALLNAME%，以认真的目光注视着自己手中的剑
「死んでほしくないし、ボクも死にたくないから」	「我既不希望爸爸死，也不愿意自己去死...」
「本気で行くよ！　手加減したら承知しないんだから！」	「所以，现在我会全力以赴的！手下留情什么的可不答应！」
%CALLNAME%は真剣なまなざしで槍を構えている	手执长枪的%CALLNAME%以严肃的目光望了过来
「当たると本当に危ないから、ちゃんとよけてね？」	「碰上的话就真的会有危险，所以一定要好好地避开哟？」
「え、手加減？　しないよ。戦場でそんな真似する敵がいるわけないじゃない」	「啊，手下留情？不会的。在战场上敌人可不会对爸爸你留手，不是吗？」
%CALLNAME%は頭上で鉄球を高速で回転させつつ、%CALLNAME:MASTER%を真剣に見つめている	%CALLNAME%认真地凝视着%CALLNAME:MASTER%，同时也将铁球举过头顶并高速地旋转着
「どーしてもこの武器振り回してると、あの人と比較されるんだけど」	「不管怎样，挥舞这种武器的话...感觉会被和西边大陆在三国时期的那位强者相比较呢」
「何時か強くなって、ボクこそがこの武器に相応しいって認めさせてやるんだから！」	「但无论如何，总有一天我会变得更强，迟早会让他们都承认，我才是最适合这把武器的！」
「変則的な武器だから、ちょっと防ぎにくいかもしれないけど」	「因为是不规则的武器，说不定会稍微有点难以防御啦...」
「だからこそ、とーさまも身を持って覚えておいた方がいいんじゃないかな」	「不过正因为如此，我也希望爸爸能够记住这一点」
「敵さんがこれ以上にトンチキな武器を振り回さない保証なんてないんだし」	「毕竟啊，爸爸也无法保证敌人不会使用比这更致命的武器，不是吗？」
「混合燃料が切れてもダメ。刃の締め付けが強すぎても、弱すぎてもダメ」	「混合燃料用完了不行，刀刃的强度太强或是太弱也不行...」
「刃の向きが違ってもアウト。……あーもー、ほんとにめんどくさい武器だなぁ」	「刀刃的方向不同也会导致出局...啊，真是把麻烦的武器啊」
「……一手ご指南お願いします」	「...请指导我吧」
そう言って武器を構える%CALLNAME%の表情は、ひどく真剣だ	那样说着并拿起了武器的%CALLNAME%挂上了非常认真的表情
「ひっさつ、%CALLNAME%ちゃんクラッシュっ！」	「一击必杀———%CALLNAME%酱要上了哦！」
トンチキな名前とは裏腹に、%CALLNAME%の剣筋はひどく鋭い	与看似冒失的表象相反，%CALLNAME%的剑筋十分尖锐
「さーとーさま、かくごー！」	「父——亲——大——人——觉悟吧！」
只の訓練だったはずの打ち合いは、今や実戦さながらの様相を呈している	本来只是一场训练，如今却呈现出了一场真正实战的面貌
%CALLNAME%の脳内辞書には、手加減という単語が存在していないようだ。落丁である	在%CALLNAME%的脑内词典里，似乎不存在手下留情这个单词
「さすがとーさま。次はボクが一本取ってやるんだから！」	「不愧是爸爸，下次让我也用这个来吧！」
「踏込が足りん！」	「有破绽！」
「……とかいえば、割となんでも斬り払える気がするなぁ」	「...不过话说回来，我感觉我现在简直可以斩断一切啊」
どうにもこうにも。%CALLNAME%は異界の法則に思いをはせているようだ	无论如何。 %CALLNAME%的思维此刻似乎是在按照另一个世界的法则来思考着的
「むー、とーさまずるい！　ボクの苦手な間合いばっかり狙って……」	「唔，好狡猾！专门就只抓住我不擅长的角度进攻什么的...」
%CALLNAME:MASTER%の戦法に、%CALLNAME%は頬を膨らませて抗議している	%CALLNAME%鼓起脸颊,抗议着%CALLNAME:MASTER%的战术
とはいえ、武器の間合いを意識させる%CALLNAME:MASTER%の”教育”に不満があるわけでもなさそうだ	不过虽然嘴上是这么说着，但%CALLNAME%显然也并不是对于让她意识到武器本身威力的最佳发挥距离与角度以及弱点的%CALLNAME:MASTER%的教育有什么不满
上目使いに%CALLNAME:MASTER%を睨ねつける%CALLNAME%の表情は、真剣そのものである	%CALLNAME%注视着%CALLNAME:MASTER%，脸上的表情逐渐变得愈发认真起来
「いくよとーさま。やー、とー」	「那么，要上了哦，爸爸」
気の抜ける掛け声とは裏腹に、%CALLNAME%の振るう武器は随分と鋭い	与那显得似乎有些泄气的口号相反，%CALLNAME%挥舞武器的气势相当锐利
「とーさま、けーこつけてくださいな♪」	「爸爸，就这样攻过来吧~♪」
「うぅ、やっぱりとーさまの方が間合いが広いや」	「嗯，果然还是父亲大人的技术更加厉害一点啊」
「いや、この時点でボクの方が大きかったらおかしいんだけどさ」	「不，如果说我现在比你更强的话，那才是真正的奇怪了」
「ひっさつ、%CALLNAME%ちゃんダイナミックっ！」	「一击必杀———%CALLNAME%酱要上了哦！」
「うぅ……とーさま。ボク眠いよ」	「唔...爸爸~我好困啊...」
「そりゃとーさまが言うならボクだって頑張るけどさ……」	「嗯...那倒是呢——如果是父亲大人说的话，我会尽量加油的」
「ほら、あれだよ。士官将帥は先頭に出ないと士気にかかわるから」	「姆...你看，那个，要是军官将帅不带头冲锋在前的话，就会影响士气什么的...」
「まずは武闘に優れているべきなんだよ。お勉強なんて無用不要だって」	「我觉得我首先应该去精研武斗才行啊...没有必要这样去学习什么的吧？」
「ねぇ。ややこしい陣形とか計略覚えるよりもさ」	「喂...比起去记着那些复杂的军阵和计略什么的」
「坦率にお腹いっぱいご飯を食べられる兵隊さんを、一杯用意できる方がいいんじゃないかな」	「让士兵们能够轻松地吃饱不是要更好一点吗？」
「えっと、これがらあるごんすとりーむで、これがぴかーどまにゅーばーで」	「哎哆...就是这样GoStream...这就是PikadoNewBar...」
……%CALLNAME%は一体いつの時代の書物で勉強しているのだろうか	...%CALLNAME%到底是在哪个时代的书本上进行学习的呢？
「ボクの指揮にぞーひょーさん達の生き死にが懸っているんだから」	「我的指挥将会关系到他们的生死」
「しっかり勉強しないとね」	「要是不好好学习的话...就会...」
「……うぞーむぞーの死だって、とーさまに不利益を与えることがあるんだから」	「...毕竟就算只是一些杂鱼的死，也是会给爸爸带来不利的」
%CALLNAME%は実に明快な価値観の元、勉学に励んでいるようだ	看来，%CALLNAME%实际上是基于某种简单明快的价值观而努力学习的
「きじょうのみみがくもん？　より実践の方が絶対いいって」	「纸上谈兵？至少练习一下是绝对不会有什么坏处的嘛」
「うぅ……軍師だって空飛んでビーム出すのがお仕事なんだし」	「唔...即使是飞到空中发出光束也是军师的工作吗？」
「こんな学問誰のためにも不能んだよ、きっと」	「这样的学问对谁都肯定是没用的吧」
「軍師ってさ、車いすに乗って移動するんだよね？」	「军师的话...肯定是坐着轮椅行动的对吧？」
「だったら烏賊にも変身できるのかなぁ……」	「那么就是说他也可以变成乌贼吗...？」
「ねえ、このしーふぉーとさんの作戦って、やったら帰ってこれない気がするんだけど……」	「呐，我想如果做好了无法返回的心理准备的话，尝试一下西福特计划也不是不可以，不过...」
「まつりごと？　えーっと、用意するのは団扇と提灯で、着ていくのは浴衣？」	「节日吗...？姆，爸爸，那么准备好团扇和提灯了吗？还有浴衣也要好好地穿上呢」
「人間よりカミサマに任せた方がいいことってあるだろうしさ」	「这些东西比起人类，还是交给神明大人要更好些吧」
「もう調停は煮え滾ったお湯に手ぇ突っ込んで、最後まで我慢した方が勝ちでいいんじゃない？」	「把手伸进滚烫的调解水中，坚持到最后的人赢得胜利，这种判断对错的方法不是要更好些吗？」
首をかしげる%CALLNAME%の案は、既に探湯ですらないような気がするのだが……	%CALLNAME%又说出了让人摸不着头脑的提案...
「とーさま、汚職官吏が見つかったんだってさ。今から斬りに行かない？」	「爸爸，听说最近查出了一个贪官。现在要去杀了他吗？」
「うん、ボクにはこっちの方が性に合ってるな。とーさまもそう思うでしょ？」	「姆，还是这种事情要更符合些我的性格。想必爸爸也是这么觉得的吧？」
気絶した汚職官吏を担ぎ上げ、頬に返り血をつけたまま。%CALLNAME%は無邪気に笑っている	抬起气绝昏迷的贪官，脸上还沾着血的%CALLNAME%天真无邪地笑着
「裏門、表門、それに二つの隠し通路はすべて抑えたね？」	「除了前门和后门之外，还有两个秘密通道都被隐藏住了吧？」
「よし、違法人身売買のアジトに吶喊だぁっっ！」	「好，现在让我们一起突入这个非法贩卖人口的窝点吧！」
そう叫び、部下を率いて突入する%CALLNAME%は	就这样叫喊着，打着头阵率领部下一同突入的%CALLNAME%
政務をしているとは思えないほど生き生きとしている	是如此的活跃，以至于让人很难相信她所从事的真的是政务工作
「調停ってさ。係争してる二人が殴り合って、最後まで立ってた方が勝ちってのじゃダメなの？」	「就这样调解吧。争执的两个人彼此间互相殴打，站到最后的人获取胜利，这种判断对错的方法不是要更好些吗？」
「判子が見つからない。ボク、今から彫りに行ってもいい？」	「找不到印章了...我可以去现雕一个吗？」
「あ、だつぜいしてる」	「啊，发现逃税行为！」
確認してみたところ、%CALLNAME%の計算間違いだった	过去确认了一下...其实是%CALLNAME%的计算错误
「びゅーん」	「嗯嗯...」
%CALLNAME%は空虚な目で紙飛行機を飛ばしている	%CALLNAME%的注意力早已被窗外飞过的纸飞机吸引过去了...
「父娘でお出かけ、嬉しいな♪」	「和爸爸一起出门~好开心啊♪」
「うん、ちゃんと見回るよ？」	「嗯嗯...好好巡视吧？」
「とーさまとイチャつくための場所だもの。治安くらい、ちゃんとしておかないと」	「毕竟是要和爸爸亲密接触的地方呢。治安什么的，如果不好好准备的话...」
「お仕事終わったら、ちゃんと約會しようね♪」	「工作结束后，就让我们好好地约个会吧♪」
「とーさまと一緒だと、警邏も捗るね♪」	「和父亲大人在一起，巡逻也会顺利进行~♪」
「やっぱ色ボケ娘が相手だと、よからぬ輩も襲いやすいみたいだし」	「果然如果是以痴女为对手的话，坏蛋也更容易被吸引出来啊...」
そう言って%CALLNAME:MASTER%に抱きつく%CALLNAME%の足元には	这样说着，%CALLNAME%紧紧抱住了%CALLNAME:MASTER%
四肢を曲がってはいけない方向に曲げた狼藉者たちが山のように積み重なっている	四肢被强大的力道扭曲，尚在呻吟的一群暴徒，就这样被硬生生堆积在一起
見た目とは裏腹の実力を秘めた%CALLNAME%は、	与外表相反，隐藏着强大实力的%CALLNAME%
確かにならず者を釣る疑似餌としては最適なのかもしれないが……	也许确实是最适合被作为钓流氓的诱饵的人选...
「あれ？　どーしたの、とーさま。頭なんか抱えちゃって」	「欸？怎么啦爸爸，抱着脑袋干嘛」
自ら色ボケと称するほど言動に問題があるのはどうなのであろうか―――――	言行上有强烈问题，甚至自称为痴女...这家伙到底是怎么一回事呢？
実父の懊悩とは裏腹に、%CALLNAME%は天真爛漫の見本のような表情で	与亲生父亲的懊恼相反，此时的%CALLNAME%正以天真烂漫的表情
打ち倒された悪漢らを回収しに来た衛兵たちに	向着那些来回收被打倒的恶徒们的亲兵们
己の武勇伝を語っている	讲述着自己的勇猛传说
「くっついちゃダメ？　ケチ～」	「欸...不可以和爸爸黏在一起嘛———小气鬼」
ふくれっ面をしつつ、%CALLNAME%は周りに目を配っている	正噘着嘴以表不满的%CALLNAME%朝着四周环顾而去
「ヨタモノやバイオスモトリに注意だね♪」	「要好好避让那些不务正业的家伙和正搬运着易碎品的脚夫啊♪」
「へ？　お歌唱練習？　いったいどういう風の吹き回し？」	「啊？歌唱练习？爸爸为什么会想到让我做这种事嘛...？」
「もしかしてとーさま。ボクの歌が聞きたいの？」	「莫非———爸爸想听我的歌吗？」
「うん、だったらいいよ。上手くなって、とーさまにすてきな歌を聞かせてあげるんだ」	「嗯，明白啦。我会加倍努力地学习音乐，让爸爸听到最棒的歌~」
「ねえ。こんなことしてるより、槍でも振り回してた方が”けんせつてき”じゃないかな」	「呐，比起这种事...舞枪时发出的声音不是要更大些吗？」
「料理？　え？　誰を？」	「菜肴？啊？什么...？」
「とーさまに食べてもらえるなら、色々やってみようかな」	「如果能让父亲大人好好吃下去的话，各种各样的东西我都会好好尝试的」
「焼いて塩かければ、大体のものは食べられると思うけどなぁ」	「大多数东西都是只需要稍微烤一下再撒点盐就可以吃了吧？」
「ねぇ、とーさまは僕にどんな風にごほーしされるのが好きなの？」	「嘻嘻...爸爸希望我以后主动用哪里来侍奉呢？」
「僕はなんだっていーんだよ？　お口でも、あそこでも、お尻でも」	「我的嘴巴，小穴~还是屁股？」
「とーさまの望むところなら、どこだって使っていい、エッチな娘なんだから」	「毕竟我就是色情的女儿嘛，只要是父亲大人希望的地方，哪里都可以使用哦」
「ふぅん、そんなごほーしの方法があるんだ」	「呼，竟然还有这种奇奇怪怪的玩法...」
「そっか、なら次はとーさまにそれ、してみたいな」	「这样啊，那么下次想和爸爸一起尝试一下」
「ううん、嫌じゃないよ」	「不，才没有讨厌哦」
「だって、そうしたら。とーさまは喜んでくれるんでしょ？」	「因为这样的话...爸爸也会高兴的吧？」
「だったら、ボクがためらう理由なんて、閻魔様だって見つけられないよ」	「那么，我还能有什么犹豫的理由嘛，就连阎罗大人都不可能找到的」
「わっ、ちょっと……。ま、待って。まだ心の準備ってものが……」	「呜啊，真是的...等等嘛，都还没有做好心理准备的说...」
「え？　ひっつくだけ？　撫でるだけ？　……あ、うん。そーだよね、あはは……」	「诶？只是这样抱着，和抚摸吗？啊...嗯，是啊，哈哈...」
「ん、なになに？　どーしたのさ。ひっついてきて」	「嗯，怎么啦爸爸，突然就凑过来...」
「ねえ、とーさま。こうしてほんの少し触ってるだけで満足なの？」	「姆，只是这样稍微触摸一下就满足了吗？」
「とーさまが望むなら、ボクはどこでだって、いつだって……」	「如果爸爸希望的话，无论何时何地都可以哦...~」
「んっ……何だかこうしていると、恋人同士でイチャついてるみたいだね」	「唔...总觉得这样做的话，就好像是调情的一对恋人一样呢」
「ううん。嫌じゃない、嫌じゃないよ」	「哎，才没有讨厌什么的哦」
「いや、そりゃ嫌じゃないよ。とーさまがしたいなら、いーけどさ」	「不，那才不是讨厌啦，如果是父亲大人的话，那当然可以的说」
「ん、わしゃわしゃされるのって、気持ちいいんだね」	「唔嗯...头发都被弄得乱七八糟的啦~不过...好舒服呢~」
「うぅ……。とーさま、恥ずかしいよ」	「呜...好羞耻...」
「とーさまの手、あったかいね……」	「爸爸的手，好温暖啊...」
%CALLNAME%は気持ちよさげに目を細め、%CALLNAME:MASTER%に体を預けている	%CALLNAME%神情舒畅地眯起眼睛，就这般将身体交给了%CALLNAME:MASTER%
「もう。後で髪、直してね……」	「姆...稍后又得重新修理头发了...」
そう言って頬を膨らませつつも、%CALLNAME%は大人しく%CALLNAME:MASTER%にその身を預けている	尽管嘴上这么说着，但鼓起双颊的%CALLNAME%最后还是老老实实地任了%CALLNAME:MASTER%的抚摸
「ん……嫌じゃないけど。髪が崩れちゃうよ……」	「姆...虽然不讨厌，但头发都被揉乱了...」
「えっ……あっと、その……。そんなに髪の毛、ヘンだった？」	「哎...啊，那个，头发...也会感觉很舒服吗...？」
「おっかしいなぁ。ちゃんと気合入れて整えてきたのに……」	「姆，明明已经干劲十足地准备好了的说...」
「いや、いーけどさ。そーゆーことしたいなら、梳子くらい持っとくべきじゃないかなぁ……」	「唔...虽然我本人并不介意，不过如果想做那样的事的话，不应该用梳子来嘛...」
「ふふ、梳子でされるのより、こっちの方が好きかも」	「呵呵，比起用梳子来梳的话，我更喜欢这样哦」
「だってさ。とーさまの体温を、こっちの方が感じられるじゃない」	「因为啊，这样的话，就可以感受到父亲大人的体温了呐...~」
「とーさま、ボクの髪の毛好きなの？」	「爸爸喜欢我的头发吗？」
「え、ボク？　そうだね。こうされるのも、嫌いじゃないよ」	「诶，我吗...？嗯，反正我不讨厌就对啦」
「えっと、嫌じゃないけどさ。優しくね？　一応、整えてあるんだから」	「嗯...很温柔吧？因为已经知道该怎么做了哦」
「ん……。髪の毛を人様に触らせるのって、なんだか不思議な感じ」	「嗯...让别人碰头发，总有点奇怪的感觉呢」
「ううん。とーさまなら、いいよ。……優しく、ね？」	「不过如果是父亲大人的话就没关系了...很温柔，对吧？」
「わ、吃驚した。」	「呜啊...吓了一跳呢」
「うぅん、いーよ。父娘のすきんしっぷってやつだね」	「呜嗯...看来我们父女俩都是水性杨花的家伙呢」
%CALLNAME%は大人しく身を任せている	%CALLNAME%倚靠着大人的身体
「ふふ……。梳子の使い方も、優しいんだね」	「呼呼...梳子的使用方法也很温柔呢」
「ん。別に、自分でやるのに……」	「唔...明明这种事情都应该是由自己做的...」
「娘がとーさまにやってもらうのって、きっと珍しいと思うけど」	「我想，女儿让父亲来帮忙梳头什么的...这种事情肯定也很少见吧？」
「ねぇ、とーさま。この子の名前は、考えてあるの？」	「呐，爸爸，你有想过这个孩子的名字吗？」
「ボクは……そーだなぁ。とーさまの決めた名前なら、きっと良いものだと思うから……」	「嗯...我想的话，如果是父亲大人给予的话，那一定会是个好名字吧」
「やっぱりさ、とーさまも待ちきれないの？」	「果然啊，爸爸也已经等不及了吗？」
「実娘に孕ませた娘だものね。どうやってちょーきょーするのか、楽しみなんでしょ？」	「由亲生女儿所孕育的女儿...很期待她会怎么做什么的，对吧？」
「うん、ボクも楽しみだな。とーさまに染め上げられるためだけに生まれる娘を産めるなんて」	「嗯，我也很期待呢。只为了被染上父亲大人的颜色而生下的女儿」
「娘冥利に尽きると思うもの……」	「我想...我的女儿，她也会因此而感到无上的荣幸吧」
「あ、動いたっぽい」	「啊，好像...在踢我呢」
「この子も、とーさまのことがわかるのかな」	「这个孩子，也能感受到父亲大人的存在吗」
「うーん、まだちょっとこの子を感知するのは難しいんじゃないかな」	「嗯，还是有点难感知到这个孩子...」
「とーさま、いでんしそーされた蜘蛛に噛まれたことないでしょ？」	「爸爸，你肯定从来都没有被蜘蛛咬过吧？」
「わっ、びっくり」	「哇，吓了一跳...」
「ねぇ、とーさま。ボクからもそれ、していいかな」	「呐，我也可以对爸爸这样做吗」
「ひゃっ、びっくりしたぁ」	「呀...吓了一跳呢」
「いや、このくらいなら、父娘でもふつーの身体接触って気がするけど」	「嗯...从这个层面上来看的话，我觉得这姑且也还算是父女之间正常的身体接触...？」
「ね、とーさま。もっかい、もっかいして？」	「呐，爸爸...再更多一点...」
「ちゅっ……んっ……」	「嗯...啾...♪」
「えへへ……。こーゆーのもこそばゆくて、なんかいいかも♪」	「嘿嘿...感觉像是浑身都飘起来了一样呢~好开心♪」
「……ちょっと、そっけない気がするな。寂しいよ」	「感觉像是有点冷淡的样子呢，好寂寞啊...」
「んー、べつにいいけどさ。うん、嫌じゃないよ、嫌じゃ」	「姆...没什么，不讨厌哦」
「んっ……。ちょっと物足りないけど。優しい感じがして、これも好き」	「嗯...虽然还是想要更加粗暴一点呢...不过，父亲大人很温柔哦？人家也不是不喜欢这个就是啦...」
「ふふっ。どうしたの、とーさま？　すっごく控えめで、優しい接吻だけど」	「呼呼...非常保守，且温柔的接吻方式呢。爸爸」
「んっ……ちゅっ……あむっ……」	「嗯...啾~哈啊...」
「んんっ……とーひゃま、これ、むるかひいよ……」	「嗯...呜嗯~太...太深了啦...」
口腔内で舌をからめ捕られた%CALLNAME%は一瞬驚きに目を見開いたが、	口腔内也被舌头侵入的%CALLNAME%瞬间便惊讶地瞪大了眼睛
口を離そうとすることは無く、逆にぎごちなく舌をからめようと奮闘している	不过她也并未选择挣脱，而是继续为侍奉父亲的舌头而努力着
「あむっ……んっ……んむっ……」	「啊...唔嗯...」
「あうぅぅ……。とーさまの舌で、ボク、犯されちゃってるみたい……」	「呜啊...感觉好像是被爸爸的舌头侵犯了一样...」
「は……あっ……む、んんっ……ちゅぱっ……」	「嗯...啊...哈嗯...」
「んっ、ちゅっ……あぁっ……とーさま、とーさま……」	「嗯...哈啊...父亲大人，父亲大人...」
%CALLNAME%は貪るように舌をからめ、熱病に浮かされたかのように%CALLNAME:MASTER%を呼んでいる	%CALLNAME%贪婪地交缠着彼此的舌，同时不住地轻声呼唤着%CALLNAME:MASTER%
「んむっ……ちゅ、ちゅっ、ん……」	「唔...啾啾...嗯...」
「ふふっ、こーしてとーさまに頤を持ち上げられて」	「呼呼...现在，被爸爸把下巴抬了起来...」
「接吻されてると、さ」	「要是这样接吻的话」
「とーさまに喉を曝け出すことになるでしょ？」	「喉咙就要暴露给父亲大人了吧？」
「すごく好きなんだ」	「呼呼...很喜欢哦」
「だって、いつでもとーさまに掻き切ってほしいって」	「因为啊，感觉像是小动物主动暴露弱点给信任的人那样呢...」
「ボクの全部をとーさまに見せてるって気がして、すごく……」	「嘻嘻...感觉我啊，现在简直就像是在向父亲大人毫无保留地展示着一切一样...太棒了...」
「わ、おいしそー。いただきまーす♪」	「哇，好像很好吃的样子哎———我开动了♪」
%CALLNAME%は饗されたご馳走に目を輝かせ、健啖という言葉の権化であるかのようにぱくぱくと平らげていく	%CALLNAME%的眼睛被眼前父亲款待的美食所吸引，随后便就像是健食一词的具象化似的，就这么埋头狼吞虎咽地吃着
「わ、これおいしい。なんなの？」	「呜哇...这个好好吃。是怎么做的呀？」
「へぇ、蒸すとこれってこんな味になるんだ……ねぇねぇとーさま。これは？　これは？」	「嗯...如果用蒸的话，这个就会变成这种味道...呐，爸爸，那这个又是？还有这个又是什么？」
酷く嬉しそうに良く食べ、良く話す実娘。色っぽい雰囲気にはなりようもないが、%CALLNAME%はとても幸せそうだ	无论是从吃相还是说话的样子来看，此时女儿都非常开心。虽然没有办法营造出暧昧的气氛，但至少%CALLNAME%看起来很幸福就足够了
「この削った小麦の生地を、赤茄子の汁ものに入れた奴ってさ」	「把这块削好的小麦面团，再放进番茄汁里...」
「汁を醤か味噌をベースにして」	「以酱油或者味噌为基础来做汤...」
「干筍や醤肉を具にして出すのもいい感じかもね」	「不过把干笋和酱肉做成配料再放进去感觉也不错」
「おいしいもの、色とりどりのものを食べるのって、心を、感性豊かにするものなんだってね」	「吃美味与多彩的食物可以丰富心灵与感性」
「そーやって風情を理解すればさ」	「如果我能以这样来理解目前的气氛的话」
「ボクはもっと沢山、とーさまの役に立てるのかな」	「不知道是不是就对爸爸更加有用了呢」
興味深げに料理をつつき、味わい。その色彩と味に感嘆しつつ	津津有味地享受着做菜与品味的过程，并为它们的色彩和味道而感叹
%CALLNAME%は真剣に考えている	%CALLNAME%认真地思考着...
「わっ……もー冷たいなぁっ！　ボクだって負けないんだからっ♪」	「哇...好冷啊！不过我也是不会输的♪」
水をかけられた%CALLNAME%はひどくはしゃいで、%CALLNAME:MASTER%との水遊びを楽しんでいる	被浇水的%CALLNAME%兴奋地享受着和%CALLNAME:MASTER%一起玩水的乐趣
「あー、もう。なんでこう、典型的な親子の遊びみたいなのを仕掛けて来るかなぁ」	「啊呀...就像是典型的亲子游戏一样呢」
水浸しになった%CALLNAME%は薄く笑って、遠慮仮借なく%CALLNAME:MASTER%に水をかけてくる	沉浸在水中的%CALLNAME%淡淡地笑着，同时毫不客气地朝着这边泼着水
「ひゃんっ♪　もぅっ！　とーさまったら、いたずらっ子なんだから……」	「嗯...呀！爸爸真是个淘气鬼...」
水に濡らされた後進技術で作られた泳裝は、裸身を隠すという本来の役目を半ば放棄している	采用落后技术制成的泳衣，在浸泡在水中后已经部分放弃了原先遮盖身体的作用
「ふふっ……坦率に見たいって言わないで、こんなことするなんて……」	「呼呼...别告诉人家说就是故意想看哦？人家原先可不敢相信爸爸你会做出这样的事呐」
薄く透けた乳首。濡れて半透明となった泳裝より見える、股間の幼くぴったりと閉じた筋	乳头处的布料几乎连乳晕都无法盖住，而透过下半身那条因沾水而变得半透明的泳裤，女儿胯部那幼小而紧闭的肉缝几乎完全可以清晰看见
%CALLNAME:MASTER%の視線を感じた%CALLNAME%は顔をほころばせ、幼い肢体を%CALLNAME:MASTER%に擦り付ける	感觉到%CALLNAME:MASTER%的视线，%CALLNAME%也不禁是露出了色气的笑，随即便主动用她年轻的身体在%CALLNAME:MASTER%的身上摩擦起来
「ね、とーさま。このまま、どうするのが一番、とーさまは興奮するの？」	「呐，爸爸，怎么样才可以让你更加兴奋起来呢？」
「教えてほしいな。……ね。娘の教育は、父親の役目でしょ？　ボクに、教えてよ」	「希望你告诉我啊，呐...教育女儿什么的是父亲的职责吧？嘻嘻...就这样说嘛~没关系的哦」
「どうしたらとーさまが、血を分けた血族の有様に興奮するのか、半分はとーさまで作られたボクに教えてよ……」	「怎样做才能让父亲大人对身为血亲的我更加兴奋起来呢~请告诉体内尚且还流着来自父亲一半的血的我吧~」
「ねえねえとーさま。この泳裝どう？　似合ってる？」	「呐，爸爸。这身泳装怎么样？合适吗？」
「とーさま、游泳なら先に行ってほしかったな。ボク、甲冑持って来てないよ」	「要是游泳的话，希望爸爸能够先去呢———我可没有带盔甲来哦？」
「え、水練のためじゃないの？」	「啊，不是要游泳吗？」
「よーし、とーさま。どっちが早いか競争だねっ♪」	「啊...明白了啦，那就是说这是一场比谁游得更快的比赛对吧♪」
……どうやらあまり色っぽいことには不能ようだ	...看来太色情的事情就是不能做的了
「水練以外で游泳ってのも、なんだかいいね」	「能够在游泳池以外的地方游泳真是太好了呐~」
「……ま、戦場での生存率を上げる訓練と思えば、悪くないかな」	「...嘛，大概是一想到这是能在战场上提高生存率的训练，就会觉得很不错吧」
ひねたことを言う%CALLNAME%だが、水面を掻く少女の表情は、そう不心情には見えないものであった	虽然%CALLNAME%说出了别扭的话，但她那拍打着水面的表情看起来也并不是那么不舒服就是了
「えっ、これ……ボクに？」	「啊，这个...给我的吗？」
「な、なんだろ。すごく恥ずかしいけど、すっごくすっごく嬉しいよ」	「什、什么嘛...好害羞...不过，人家非常———非常开心哦？」
「ね、とーさま。その、えぇっと……似合うかな」	「呐，爸爸，你看这个...嗯，合适吗？」
花冠を被せられた%CALLNAME%は顔を真っ赤にし、もじもじと上目づかいで%CALLNAME:MASTER%に感想を求めている	被戴上花冠的%CALLNAME%满脸通红，忸怩片刻后也还是抬起头来，向%CALLNAME:MASTER%开口寻求着感想
「え？　ボクに作ってくれたの……」	「诶？这是...给我做的吗？」
「そ、そりゃ嬉しいけどさ。さすがにちょっと恥ずかしいよ。もう……」	「那个，虽然很开心...但是，还是好害羞嘛...」
%CALLNAME%は顔を真っ赤にし、花冠を身に着けるでもなく、しかし手放すわけでもなくもじもじとしている	通红着脸的%CALLNAME%双手捧着递来的花冠，最后还是忸忸怩怩地将它戴在了自己的头上
「わ、とーさま。また作ってくれたんだ」	「哇，爸爸，又为我做了一个！」
「ううん。何度だって、嬉しいよ。きっと女の子なら、誰だってそうだよ」	「不...不管多少次，我都会很开心的哦。我相信...只要是女孩子，就肯定都会为此而高兴的」
「ね、とーさま。とーさまが被せてくれないかな」	「呐，爸爸，能不能自己也戴上一个给人家看看呢」
「うん、意味は無いよ。ボクのわがままだ」	「欸...没有什么特别的意义哦？单纯只是人家想看而已」
「でもさ。その方が、そうでないよりも何倍も、何倍も」	「不过虽然如此，但是嘛...那也比没有要好上很多很多倍哦」
「ボクたちにとってステキなことだと思うんだ……って」	「我认为这对我们来说，都是一件很棒的事...呐」
「ちょっと、真顔で突っ込み入れないでよ！」	「喂，别一本正经地插嘴啊」
「ちょっとくらい、気氛に浸ってみたっていいじゃないかぁ、もうっ！」	「稍微，稍微试着沉浸在这气氛里不是很好吗，真是的！」
「……とーさま。絶対ボクの反応見て楽しんでるでしょ」	「...爸爸，你一定很期待看到我的反应吧」
%CALLNAME%は花冠を手に恨めしそうに%CALLNAME:MASTER%を睨ね付け、	%CALLNAME%一脸不满地盯着%CALLNAME:MASTER%，
そっと優しげに%CALLNAME:MASTER%の作った花冠を抱きしめた	不过最后还是鼓起脸蛋，将它戴在了头上
「ねぇねぇとーさま。大物射止めたら、美味しいもの作ってくれる？」	「呐，爸爸。如果我们射中了一头大猎物的话...能给我做好吃的东西作为奖励嘛？」
話を持ちかけられた%CALLNAME%は随分と乗り気で、いそいそと弓を準備している	被答应的%CALLNAME%干劲满满地准备着弓箭
……獲物を料理するのは、%CALLNAME:MASTER%の役目になりそうだ	...%CALLNAME:MASTER%简直都快要成为专门料理女儿猎物的厨师了
「そーだね。たまには人間以外も射らないと、勘が鈍っちゃう」	「是呢，如果不去偶尔射击人类以外的动物的话，感觉都会变得迟钝起来的」
しれっと物騒なことをのたまった%CALLNAME%は、いそいそと弓を取り出し、獲物を物色している	%CALLNAME%默默忍耐着周边的噪音，缓缓地取出了弓箭，熟练地物色着猎物
「ね、ね、とーさま、見て！　大物堕としたよ！　大物！！」	「喂———喂，爸爸，快看！打到了大家伙的说！大猎物！」
耳を劈く轟音と、視界を覆い尽くす土煙。そして、三半規管を破砕せしめんとするかのような地響き	响彻的轰鸣声仿佛要将三半规管都震裂开来那般，随之而来的，就是巨物坠地所扬起的，铺天盖地涌来的大片尘土
あまりにも巨大な生物が落下した故の惨状の中、喜色満面といった風情の%CALLNAME%の声が響く	伴随着原先飞于空中的巨大生物坠落的惨状一同出现在视界里的，是充满着喜色的%CALLNAME%的声音
「ほら、ほら、見て！　おっきなトカゲだよ！　きっとおいしいよ？　どう料理するのかは知らないけど！」	「看！看呀，这么大的蜥蜴！虽然我也不知道该怎么做才好，但反正一定会很好吃的吧！」
跳ね回らんばかりの様子で%CALLNAME:MASTER%の腕にまとわりつく実娘を傍らに	兴奋的%CALLNAME%缠绕在%CALLNAME:MASTER%的手臂上，兴奋得仿佛就要原地跳起来般
%CALLNAME:MASTER%は恐るべきウィズ・ワームの調理方法について頭を悩ますこととなったのであった……	%CALLNAME:MASTER%不禁开始为这头奇异生物的烹饪方法而头疼起来...
「うーん、逆鱗撃ち抜いても、そうそう堕ちるものじゃないみたいだなぁ」	「姆，即使是已经把逆鳞射穿了，也没有这么容易就掉下来啊」
仕留め損ねた明快に地面に影を落とす大物を仰ぎ見て、%CALLNAME%は無念そうにぼやいている	%CALLNAME%抬头望着那头逃走的大猎物，不禁沮丧地抱怨道———虽然也射穿了弱点，而且它也明显有了坠地的趋势，但最后也还是没能彻底使之彻底失去活力
「あちゃぁ……やっぱ逆鱗狙わなきゃそうそう墜ちてくれる相手じゃないかぁ……」	「啊呀...果然是不瞄准逆鳞的话，就肯定无法射杀的猎物啊...」
その鱗で易々と%CALLNAME%の矢を弾いた巨大飛行生物を仰ぎ見て、少女は残念そうにそう呟いている	少女仰望着用鳞片就轻易弹开了射来的箭矢的巨大飞行生物，遗憾地低声说道
「んっ……とーさま、なんだか手つきがやらしくない？」	「嗯...爸爸，不觉得自己的手法什么的...有些下流嘛？」
「そ、そりゃ嫌じゃないけど……」	「姆，虽然也并没有讨厌...」
「背中弄られるのって、ふつーのエッチと違ってなんかくすぐった……ひゃっ！」	「玩弄后背什么的，与普通的H不一样，总觉得好痒...呀啊~！」
あまり触られ慣れていないのだろう	或许是不太习惯后背被人这样摸吧
%CALLNAME:MASTER%が手拭いでそのきめ細やかな背を拭くたびに	每当%CALLNAME:MASTER%擦拭女儿那细腻的脊背时
%CALLNAME%は小さな体を震わせ、おおよそ浴場のそれには似合わぬ嬌声を上げている	%CALLNAME%都会颤抖着娇小的身体，发出与浴场的环境并不相称的娇吟声
「とーさまに洗ってもらうの、好きだな」	「爸爸来给我洗澡什么的...最喜欢了哟~」
「とーさまがボクのおとーさんで」	「在这过程里呀...」
「ボクはその娘なんだって、すごく実感できるもの」	「我会更加强烈的感觉到，自己作为女儿的实感哟？」
「わひゃっ！　もう、とーさまったら♪」	「呜哇~爸爸的搓澡时间到了♪」
泡を流すべく%CALLNAME%の背中から湯をかける%CALLNAME:MASTER%	%CALLNAME:MASTER%向着%CALLNAME%那留下泡沫的背后浇上热水时
%CALLNAME:MASTER%の娘はくすぐったそうに笑い	%CALLNAME%就不禁因痒感而咯咯地笑了起来
%CALLNAME:MASTER%の腹部にぺたんと背を預ける	除了被%CALLNAME:MASTER%的腹部紧贴着的后背以外
胸をくすぐる髪のくすぐったさに思わず視線を降ろせば	如果将视线投向垂落到她胸前的头发的话，大抵也就明白这痒感究竟是从何而来的了
湯に濡れ、乏しい照明によって濃い陰影を描かれた	在被热水所濡湿的身体上了，昏暗的灯光投射出深深的阴影
%CALLNAME%の裸身が視界へと飛び込んでくる	%CALLNAME%的裸身跃入视野
整った乳房、そこから続くなだらかで引き締まった腹部	形状优美而整齐的胸部，光滑紧实而平坦的肚腹
鍛えられているが故の張りと、	少女那柔软而健康的双腿
少女らしい柔らかさを両立させた健康的な太もも	因长久训练而也额外增添了几分紧致之感
そして、年齢相応に未成熟なまま、	以及，与年龄相称，并未成熟的
%CALLNAME:MASTER%の手によって淫らに躾けられた局部―――――	被%CALLNAME:MASTER%的手所淫乱地教育了的秘部――――――
そこまで視線が動いたところで、己を見る双眸に意識が行く	当视线移动到这等地步后，%CALLNAME:MASTER%方才意识到
悪戯っぽく、そしてどこか蠱惑的に笑う%CALLNAME%のものである	%CALLNAME%的眼睛正含着恶作剧般的笑意注视着自己
「もー、とーさまったら、どこ見てるのさ」	「嘛~父亲大人，你到底在看哪里呀~？」
「折角健全に”父娘のすきんしっぷ”っぽいことしてるんだから」	「好不容易是在健全地做着“父女的亲密行为”这种事情」
「そっちを楽しもうよ」	「结果现在却又要来享用人家了吗~」
「……だって、その方が。ボクととーさまが娘と父親なんだって」	「...呼呼，毕竟啊，我和爸爸是父女关系」
「血を分けた親子なんだってすごく身近に理解できた方がさ」	「血脉相通的亲子之间，能够很容易地就理解彼此的意思」
「……あとでボクを組み敷く時、ずっとずっと、興奮すると思わない？」	「难道爸爸都一直没有感觉到嘛，当你让我躺下来的时候...我一直都很兴奋什么的吗？」
だから今は、ね？　そう続ける%CALLNAME%	所以现在呢...？
とはいえ、そんなことを言われて	虽然嘴上是这么说着
健全な父娘の身体接触とやらができるわけもない	但是，父女关系———至少与%CALLNAME%之间，是不可能有什么健全的身体接触的
結局%CALLNAME%は己の背を擦る硬くなった%CALLNAME:MASTER%の肉棒に嬌声を上げ	此时，%CALLNAME%因摩擦着自己后背而变得充血坚挺的%CALLNAME:MASTER%的肉棒的持续动作，而情不自禁地发出了淫荡的娇声
抗議の声は口づけと水音へと変わっていく	抗议的声音很快就变成了亲吻声与水声
”ずっとずっと”であるかはさておいて	不管是否能够“一直”持续下去
%CALLNAME:MASTER%と%CALLNAME:MASTER%の眷属は、	不过至少此刻，%CALLNAME:MASTER%与%CALLNAME:MASTER%的女儿
交歓を楽しめる程度には湯屋での逢瀬を堪能できたようだ	是正在享受着在澡堂中彼此交欢的快乐的...
「え、手で？　いいけど、きっとうまくできないよ。やり方教えてね」	「欸，要用手来做吗？虽然的确是有趣的玩法，但我没有经验的话肯定也做不好...所以，请教教我大概的做法吧」
「手で握るの？　んー。まぁとーさまのだし、いいよ。……こんな感じ？」	「要用手握着吗？嗯...然后这样反复套弄着，咻咻的...这样的感觉？」
「えっと、こんな感じに握って、こすればいいの？」	「嗯，只要把它握着，以这种节奏套弄就可以了嘛？」
「あ、なんか先っぽからおつゆが出てきてる」	「啊...总感觉前面好像已经有先走汁出来了...」
「んっ……掌の中で、びくびくって脈打ってる……せーえき、出したいの？」	「嗯...在手掌中，战战兢兢地跳动着...姆，想射了吗？父亲大人」
「とーさまが気持ちよくなってると、ボクまで気持ちよくなってきちゃう……」	「爸爸舒服起来的时候，我的心情也会跟着变好呢...」
%CALLNAME%は巧みに肉棒を愛撫し、霞がかかったかのような瞳で溢れ出る先走り汁を見ている	%CALLNAME%巧妙地爱抚着肉棒，以她那朦胧的眼睛注视着其顶端所溢出的先走汁
「は……あっ……とーさまのおちんちん、びくびくしてて、ボク……もう……」	「啊啊...爸爸的肉棒正在一跳一跳的...就这样看着的我甚至也...」
%CALLNAME%は脈動する肉棒を手にするだけで荒い息を上げ、強い劣情を催している	%CALLNAME%仅仅握着%CALLNAME:MASTER%那根正在跳动着的肉棒，呼吸就不禁沉重起来，悄然间也不禁因此而产生了强烈的欲望...
「んっ……とーさまの、すごい」	「嗯...父亲大人的...好厉害」
「あつくて、ぐちゅぐちゅに濡れてて、臭いだけで、頭の中まで犯されてるみたいで……」	「热热的，湿成这种样子，还有那种独有的臭味...感觉简直脑袋都被狠狠地侵犯了...」
熱に浮かされたような視線で%CALLNAME:MASTER%を見上げながら、%CALLNAME%は弱点を知り尽くした動きで肉棒をしごき続ける	%CALLNAME%一边以热烈的视线仰望着%CALLNAME:MASTER%，一边不住重复着刺激弱点的动作，使得肉棒不住地颤动着
「ね、とーさま。このまま手も、顔も、胸も、身体も……全部全部汚し尽くして」	「呐，父亲大人，就这样把我的手，脸还有胸和整个身体...全部都彻底地染上你的颜色吧」
「ボクの手で気持ち良くなって、熱いせーえき、いっぱい、いっぱい出して……」	「就这样用我的手来变得舒服起来吧...热热的肉棒，就这样射出好多好多...♪」
「んっ、なんか、変な味……」	「总感觉，有什么奇怪的味道...」
「とーさまが望むなら、いーよ。……でも、変な味かも」	「如果父亲大人想要的话，就尽情做吧...只不过，味道真的很奇怪欸...」
「うぅ、とーさまがやれって言うならやるけどさぁ……」	「唔...如果是父亲大人让我做的话，当然可以」
「も～。今回だけだからね？」	「姆...就这一次吧？」
「んー。まあとーさまが望むなら……ごほーし、するね？」	「嗯姆...如果父亲大人想要的话...呼呼，那就做吧？」
「いーよ。とーさまのためだもの」	「嗯...这是爸爸的...」
「……でも、変な味」	「...虽然有些奇怪的味道呢」
「どう、気持ちいい？」	「感觉怎么样，舒服吗？」
%CALLNAME%は上目遣いに%CALLNAME:MASTER%を見上げながら、肉棒に舌を這わせている	%CALLNAME%的舌头在肉棒上不住舔舐着，同时也主动将视线上移，凝望着%CALLNAME:MASTER%
「あ、出そうなんだ。いいよ。とーさまの白いの、嫌いじゃないから」	「啊，好像要出来了吗？可以哦，我并不讨厌爸爸的精液...的说~」
%CALLNAME%はにじみ出た液体を目を細めてすすりつつ、奉仕を続けている	%CALLNAME%稍微眯着眼睛，主动啜饮着溢出的液体，随后很快也就继续投入到了侍奉的动作里
「喉の奥に出されるとさ……ん、ちゅっ……」	「每次肉棒插到喉咙最深的地方的时候...嗯...呼...」
「お腹がかっと熱くなって、おまたがじんっとするの」	「我的肚子里就会感觉热热的，浑身都没有力气...」
「はむっ……おちんちん……おいし……ん……」	「哈啊...嗯...小鸡鸡...好吃，唔...」
%CALLNAME%にとって、口交はただそれだけで快楽を得るための行為になっているようだ	对于此时的%CALLNAME%来说，口交也已经成了能够从中获取快乐的行为...
「あ、おちんちん……あむ……んちゅ……ん」	「啊，小鸡鸡...啊姆...啾...嗯...」
差し出された肉棒を、%CALLNAME%はごく自然に加え、うっとりとした表情で舌を這わせていく	%CALLNAME%将伸出的肉棒极其自然地纳入口中，带着陶醉的表情在其上方来回舔舐着
「とーさま。ん……ちゅ……喉の奥に、びゅー、びゅーって出して。精液、飲ませて……んっ……」	「父亲大人...嗯...啾，喉咙里面，就这样...咻咻地——射出来——让我喝你的精液...嗯...」
塗したよだれと、先走り汁でべとべとになったそれを忘我の表情で頬張り、舐めあげる	%CALLNAME%用忘我的表情舔舐着肉棒上那些由自己的唾液与先走汁混合而成的液体
今の%CALLNAME%は、精液を飲むことしか頭にないようだ	看来此时的%CALLNAME%脑袋里已经是只想喝精液了...
「……一回だけだよって、言ったんだけどなぁ」	「虽然说好了只做一次...」
%CALLNAME%はそう不満を口にしつつも、%CALLNAME:MASTER%の肉棒に舌を這わせている	尽管%CALLNAME%还是表达着不满，但接着也还是主动将舌头伸向了%CALLNAME:MASTER%的肉棒
「胸でする？　ふぅん、いーよ」	「用胸部来做...？嗯唔...」
とーさまも変わったことを思いつくなぁ……とぼやきつつも、%CALLNAME%は坦率に%CALLNAME:MASTER%に従った	爸爸又想到了奇怪的事情...一边嘟哝着，但%CALLNAME%这次也还是顺从了%CALLNAME:MASTER%的要求
「ねぇ、とーさま。これってほんとに気持ちいの？」	「呐~~爸爸...这样真的没问题吗？」
「手でした方がまだマシなんじゃ……」	「至少还是用手或者别的什么比较好吧...」
「んっ……ちゅっ……どう？　とーさま、気持ちいい？」	「嗯...啾，怎么样？父亲大人，舒服吗？」
「え、ボク？　えっと、なんかくすぐったいかな」	「诶，我...真是的，为什么会感觉里面痒痒的啊...」
「ちゅっ……ちゅっ……　あれ？　ごほーししてるのに、先っぽが硬くなってきちゃった……」	「啾...嗯...明明只是把它包起来，前面就又变硬了...」
肉棒を挟んだ%CALLNAME%の乳房の中央で、桜色の突起が僅かに充血している	在%CALLNAME%那对夹着肉棒的乳房中央，樱色的突起正微微充血而硬挺起来
「んっ……とーさまの熱いのが擦れて……なんだか、変な感じ……あっ……」	「嗯,..爸爸的肉棒在磨擦着...总感觉，好奇怪...啊啊...」
胸と口で%CALLNAME:MASTER%に奉仕しつつ、%CALLNAME%は僅かに感じているようだ	用胸部与嘴巴为%CALLNAME:MASTER%服务的时候，似乎%CALLNAME%的内心也会有些微的愉悦感觉...
「ひゃっ……あっ……。とーさま、だめぇ……」	「哈啊...啊...父亲大人，不，不可以...」
「ボクがごほーしするんだから、おちんちん乳首に擦り付けちゃ……」	「明明是要人家把肉棒包起来的，但是...现在却在摩擦乳头...」
「ひゃうぅぅっ！！」	「嗯啊啊~~」
「あ……すごい……。とーさまのおつゆと、ボクの唾液で、んっ……」	「啊...好厉害...爸爸的先走汁，还有我的口水，嗯...」
「胸がもうグチャグチャだよ……あむっ……れろっ……」	「我的胸部已经被玩弄得乱七八糟了...啊...哈啊...」
「こんなにドロドロにされたら、ボク、おかしくなっちゃいそう……」	「如果再这样下去的话...我...我就要变得奇怪起来了...」
%CALLNAME:MASTER%は霞のかかったような瞳のまま肉棒に舌を這わせ、二人の体液でぬめった乳房を擦り付ける	%CALLNAME:MASTER%用她湿润的眼睛注视着那正被舌头舔舐着的肉棒，同时也主动揉搓着被彼此的体液所濡湿的乳房
真っ赤に充血した乳首が肉棒に当たるたびに、その幼い肢体がびくりと痙攣した	每当充血的乳头碰到肉棒时，她那幼小的身躯便会猛地颤抖
「は……あっ……む……れろっ……ボクの胸、とーさまので犯されちゃってる……」	「哈...啊...呀啊...我的胸部，就这样被父亲大人侵犯了...」
「もう胸がとーさまの形、覚えちゃったよ……ぐちゅぐちゅの熱いので、とーさま専用にされちゃうよ……」	「胸部已经记住了父亲大人的形状...感觉里面，又热又湿...就算是这里也已经也成了父亲大人专用的性玩具了啊...」
唾液とカウパーの混合液で泡立つ胸の谷間を、肉棒が往復する	阴茎在她的乳沟间来回抽送着，在乳沟间沾满了唾液与先走汁的混合液
%CALLNAME%は時折自らの乳首をこすりつけるようにしながら、%CALLNAME:MASTER%のものに奉仕している	%CALLNAME%就这般侍奉着%CALLNAME:MASTER%的肉棒，同时也摩擦着自己的乳头
忘我の表情で肉棒に乳房を捧げる%CALLNAME%の淫唇は触れてもいないのに愛液を吐き出し	%CALLNAME%带着忘我的表情用胸部侍奉着肉棒，即使蜜唇直到此时为止都根本未曾被侵犯过，片刻后爱液也还是从中喷涌而出
太腿を伝って床に水溜りを作っていた……	淌流而下的液体就这般在地上形成了一片水洼...
「そっか、ボクの初めて、貰ってくれる……え、違うの？」	「姆...这是我的第一次哦...啊，不对吗？」
「おまたで擦るの？　いーけど……ちょっと寂しいな」	「欸...只是想用大腿来摩擦吗？姆...」
「うん。来て、とーさま……って、え？　違うの？」	「啊...要来了...爸爸的...哎？不对吗？」
「おまたで擦るの？　そりゃとーさまがそうしたいならいーけど……」	「嗯...只是用大腿摩擦...姆...如果爸爸喜欢的话那就随意好了」
「いや、とーさま。ちょっとタンマ！」	「不，爸爸，稍微等等！」
「父娘でそれはマズイって……」	「明明我们是父女哎...真是...」
「え、入れない？　擦るだけ？　それなら、まぁ……」	「欸...不插进去，只是在外面蹭...？那么，嘛...姑且也还是允许了...」
「ねぇ、とーさま。このままボクの初めて、貰ってくれないの？」	「呐，爸爸想就这样收下我的第一次吗？」
「そりゃこれも……んっ、気持ちいけど……ひゃぅっ！　ま、待って……そこ、弱いから……あぁぁっ……っ！」	「就算只是摩擦也...嗯...感觉不错，但是...哈，等，等等...这里是弱点的说，不要摩擦那边...嗯啊啊...♥」
「ん……とーさま、ボクが動くから……ひゃんっ……待って」	「嗯...爸爸，你看，我会动的...呀，等...等一下」
「敏感なとこ、おちんちんでこすっちゃ……ひゃぅっ！」	「竟然直接用肉棒摩擦那里...嗯啊...坏蛋...♥」
「とーさまも、ボクも気持ちよくなれるんだけど……。なんか釈然としな……ひゃんっ」	「我和父亲大人现在...都舒服起来了呐，就算是不插进来也没关系了...啊嗯...♥」
「とーさま、喋ってる途中でお豆さん擦るのだめ……あぁぁっ！」	「唔...呜啊，爸爸，说话的时候不许欺负小豆豆...嗯啊啊~~♥」
「とーさま、ボクなんか変だよぉ。もう我慢できないんだ……」	「爸爸...感觉好奇怪啊...不，不行...要忍不住了的说...」
「お願い、こんな変態なボクだけど嫌いに不能で……！」	「就算是我是个这样的变态...爸爸也不许讨厌！啊...还有...拜托了...」
「なんかムラムラしてきちゃった……ね、とーさま、ちょっとだけ……♪」	「总觉得性欲好强...呐，爸爸，过来一点...♪」
「え、こんなところで……？　もう、とーさまってば、しょうがないなぁ……♪」	「哎，在这种地方...用嘴来吗？虽然和爸爸呆在这里的我，也忍不住呢...♪」
「え、こんなところで……　とーさま、正気？」	「哎，在这种地方来...爸爸，你...没问题吧？」
「えうう～　わ、わかったよぉ……」	「呜啊啊~明...明白了嘛...」
「オトコのユメ、ってヤツ？　んもぅ、しょうがないにゃあ♪」	「这就是所谓男人的梦想吗？嗯...那就没办法啦♪」
「見ててよ、机の上のことなんか、んっ、手につかなく、ヂュっ、させてあげるから…」	「那么，就请把桌上的事情放下，然后好好地看着我吧？人家...会好好帮父亲大人处理性欲的说」
「んー、そうだね。とーさまがカイテキにお仕事できるよう」	「嗯，是这样呢，为了让爸爸能够好好地工作...」
「気持ちよくさせてあげるのも……んっ……」	「让他舒服起来也是...嗯...」
「ムスメの義務……あむっ……ちゅっ……だよ、ね？　……ん、むっ……」	「女儿的义务...啊...啾...对...对吧？嗯...」
「ふふっ……こんなの、誰かにばれたら大変だよ？」	「呼呼...这样啊，那要是被谁发现了可就糟糕了哦？」
「とーさまが、娘をちょーきょーして公の場でごほーしさせるヘンタイさんだって」	「父亲大人是个会在大庭广众之下取笑自己女儿的变态呢」
「んっ……はむっ……満天下に……ちゅっ……バレちゃうよ？」	「嗯...哈啊...这样的话...啾...会暴露给...全世界的人...姆...都知道的哦？」
「うわっ、とーさまのコレもう蒸れ蒸れのビンビンだぁ……」	「嗯...爸爸的肉棒...又热又硬...甚至都在冒着蒸汽呢...」
「うん、綺麗に、してあげるね……？」	「嗯...我会让它看起来更漂亮的呐...」
「ひゃっ……凄い、とーさまの臭い……」	「啊...好棒...爸爸的味道...」
「嗅いでいるだけで、頭がぼーっとして……ん……んちゅっ、むっ……」	「只是稍微闻闻，脑袋就已经是一片空白了...嗯...呼唔...」
喋っている最中に我慢が利かなくなったのか	在说话的时候，你的欲望变得更强了吗？
言葉を言い終わらぬうちに%CALLNAME%は%CALLNAME:MASTER%の肉棒にむしゃぶりついていった	话都还没说完，%CALLNAME%就把%CALLNAME:MASTER%的肉棒狠狠地吸了下去
「はぅ……とーさまの、とーさまのニオイだぁ……」	「嗯...爸爸的...爸爸的气味啊...」
取り出された%CALLNAME:MASTER%の肉棒を前に、%CALLNAME%はにへらと相好を崩し	在%CALLNAME:MASTER%那根被取出的鸡巴面前，%CALLNAME%在颤抖片刻后，便不禁是露出了淫荡的表情
指示を待つことなく、自身を作り出した陰茎へと舌を這わし始めていった	没等%CALLNAME:MASTER%开口指示，她的舌头便开始自主地向那根曾创造出自己的阴茎伸去
「ボクが歌っているところを見て興奮したの？　えへへ、嬉しい♪」	「看到我唱歌的时候，爸爸也会兴奋起来吗？诶嘿嘿...好开心♪」
「あ、とーさまのが汚れちゃった……ボクが綺麗にしてあげないと……」	「啊，爸爸的肉棒脏啦...可得让我好好清理一下哟...？」
「きゃあっ！　もう、とーさまってば…いいよ、復習は大事だもんね…」	「啊呀！嗯...是，是这样呢...复习用嘴来侍奉的课程什么的也是重要的事情...」
「えへへ……誰か来たら、って思うと興奮しちゃうね……」	「嘿嘿...一想到亲近的是谁的肉棒，我就会兴奋起来...」
「んっ……あむっ……ちゅっ、ん……む……」	「嗯...啊...」
「ん……やっぱりお湯があるからかな」	「嗯...果然是因为热水的原因呢」
「なんだかとーさまの味が薄いよ」	「总觉得上面的味道很淡啊...」
「あ、でも大丈夫。すぐに濃くなるよね」	「啊，但是没关系。很快就会变得浓烈起来吧」
「ごほーしして、鈴口から啜っちゃえば」	「首先啊，从上面这里开始舔...」
「とーさまのがどこにあるかなんて気にしなくていいんだから」	「呼呼...不用担心哦？只会让爸爸好好地舒服起来哟」
「あはっ♪　すごい匂い」	「啊哈♪好香啊」
「今洗ったばかりなのに、もう鈴口からおつゆをたらして」	「虽然刚洗完澡，但是先走汁很快就流出来了哟」
「すごいや。匂いだけでボク、おかしくなりそう」	「真棒呢。只要闻到爸爸的味道，我就会变得奇怪起来...」
霞がかかった瞳でそう笑った%CALLNAME%は	在%CALLNAME%那朦胧的眼中，带着淫靡的笑意
湯船から顔を出す、ガチガチに張りつめた%CALLNAME:MASTER%の陰茎に	随后便从浴池里露出脸来，紧紧贴在了%CALLNAME:MASTER%的阴茎上
そっと口づける	轻轻地吻上前去
「んっ……ちゅっ……」	「嗯...啾...」
「まずは、さ。ボクの口を犯してよ」	「首先是，请侵犯我的嘴巴吧」
「だって、そうでしょ？」	「呼呼...是这样吧？」
「ボクは全部とーさまのものになるんだもの」	「我会全身心的彻底变成爸爸的东西」
「あたまだって、のーみそだって、とーさまのモノにならなきゃいけない」	「不管是这颗脑袋还是里面的脑髓，都只能是父亲大人的东西」
「だから、さ。そのお湯の中でも元気なそれで、ボクのお口を凌辱してほしいな♪」	「所以啊...嘻嘻，希望父亲大人能够用这根在热水里也很有精神的肉棒来狠狠凌辱我的嘴巴呢♪」
「うん、いいよ…ボクのお口で、いっぱい気持ちよくなってね……♪」	「嗯，好啊...就这样用我的嘴，变得舒服起来吧~♪」
「いいのいいの、ボクがしたくなっただけだから。とーさまはそのまま続けてて」	「呼呼~没关系哦？单纯只是我想做而已~如果就这样继续下去的话...」
「続けられるものなら……ね？」	「如果就这样继续下去的话...呐？」
「んっふっふ～、とーさまのこれギンギンじゃ～ん。ボクの汗にそんなに興奮した？」	「呼呼呼~父亲大人还真是变态呢，竟然会对我的汗水感兴趣吗？」
「わかってるって、疲れマラって言うんでしょ？　ボクが鎮めてあげるから……♪」	「我知道哦？爸爸只是训练得累了对吧？没关系哦，我会让你好好舒服起来的♪」
「♪父上さま～お元気ですか～」	「父亲大人~您的身体还好吗~♪」
何処に歌いかけているのだ、何処に。	你在哪里歌唱着呢，在哪里？
「何処って言うか、ナニ？　それにここは嬉しそうにピクピクしてるよ？」	「我该回答哪里呢？哪里？您的身体好像也很兴奋呢~不是吗？」
娘の口唇に色気を感じたのには否定できないが…	也无法否认女儿的口唇的确是存在着某种魅力...
「じゃあいいよね？　いただきま～す」	「是这样吗~？那么我来啦~」
「ごめんなさいとーさま、こぼしちゃった～（棒）」	「对不起爸爸，我把东西给弄洒了~（捧读）」
今おもいっきり股間めがけてブチ撒けなかったか？	现在就不能用水来好好冲洗干净吗？
「そんなことないよ～（棒）それより、このままだとベトベトするでしょ？　ボクが綺麗にしてあげるね♪」	「没有那样的事哟~（捧读）比起这个，再这样下去的话会粘起来吧？就让我来用嘴好好给父亲大人清理一下吧♪」
「とーさま、こっちに来て…そうそう、ここなら……誰にも見られないよね？」	「爸爸，到这边来...嗯嗯，如果是这里的话...那应该就是谁也看不到了吧」
そう言うが早いか、あっという間に肉棒を引きずり出すと、%CALLNAME%は喉の奥まで一気に飲み込んでしまった	刚这么说完，%CALLNAME%就主动把%CALLNAME:MASTER%的肉棒从裤子里拿了出来，紧接着便一下子将其咽到了喉咙深处
「ん゛ん゛ん゛～～こえ、ふぉくの（これ、ボクの）～～ふぁれえにほ（誰にも）あげない～～」	「嗯~~嗯...爸爸的肉棒是我的~~才不会给任何人~~」
咥えたまま喋られると、刺激が…………！	含在肉棒含混不清地说话什么的...好刺激...！
「洗っただけじゃ、ほんとに綺麗になったか分からないでしょ？」	「只是清洗过什么的，也不知道到底是不是真的干净了吧？」
「ボクがちゃぁんと、舌で清めてあげる」	「就这样让我好好地用舌头来帮助清理吧~」
「ねぇとーさま、いいでしょ…？　ボクもうがまんできないよぉ……」	「呐，爸爸，可以吧...？我已经快要忍不住了...」
「ふふ、とーさまがボクの初めてのひとだぁ……」	「呼呼...爸爸拿走了我的第一次呢...」
%CALLNAME%はシーツの赤い染みに目を向け、愛おしげに呟いている	%CALLNAME%将目光转向床单上的血渍，充满爱意地轻声说道
「ひどいやとーさま。初めてくらい、自分で奪ってくれたっていいじゃないか……」	「太不像话了啦...人家的第一次，亲自来夺走什么的不是更好吗...」
「あれ？　とーさま、どうしたの？」	「欸？爸爸，怎么啦？」
「そっか、ボクの中にしゃせーしてるんだ……」	「明白啦...它正在注入我的身体里...」
いまだ肉棒を受け入れることに慣れていない%CALLNAME%には、射精されたことを感知する余裕がないようだ	还没有习惯接受肉棒的%CALLNAME%，似乎已经没有再去感知里面被射精了这种事情的余力了
「あっ……とーさまのがどくっ、どくって震えてたね」	「爸爸的...进来了呢...感觉浑身都在颤抖着...」
「そっか。ボクちゃんと、とーさまに出してもらえたんだ」	「这样啊...爸爸把诞生出我的东西射进来了呢...」
僅かに解れてきた膣を陰茎で貫かれたまま、%CALLNAME%は荒く息を付きつつ微笑んだ	当阴茎插入她稍微放松的膣道时，微笑着的%CALLNAME%的呼吸也不禁粗重起来
「んっ……あったかいのが……」	「嗯...暖暖的...」
「なかで、びゅーって……」	「注进里面来了...嗯...」
放たれた白濁液の熱に僅かに身を震わせ、%CALLNAME%は%CALLNAME:MASTER%の子胤を身に受けた喜びに頬を緩ませている	%CALLNAME%的身体因注入体内的子种汁的热量而轻微颤抖着，同时脸颊也因知晓自己的身体已然接受%CALLNAME:MASTER%的后代而喜悦地舒缓开来
びくり、びくりと脈動し精液を吐き出す肉棒の動きに、%CALLNAME%は背筋を震わせる	当阴茎颤抖、脉动并吐出精液时，%CALLNAME%的脊椎也在颤抖着
「……体の奥に出されるとね、なんだかぴりっときて、ぞくぞく体が震えるんだ」	「...每当这些进入到里面的时候，我就会感觉到里面火辣辣的...好烫，弄得整个人都不由自主地颤抖起来...」
「ねぇ、とーさま。ナカダシされて気持ちよくなっちゃういけない娘に、お仕置きしてくれないかな」	「呐~爸爸，你会惩罚我这个无法忍耐想要被侵犯的欲望的淫荡女儿吗？」
「うん、そう。そんなエッチな娘の膣はもっととーさま好みに変えていかなきゃいけない」	「嗯...是这样呢。这么淫荡的女孩子，她的小穴需要被调教到更符合爸爸的喜好才行」
「そう思うでしょ？」	「嗯，爸爸肯定是这么想的吧？」
そう言って%CALLNAME%は幼いかんばせを淫靡にほころばせ、%CALLNAME:MASTER%の胸板に頬を寄せた	年幼的%CALLNAME%的脸颊上绽放出了淫靡的微笑，在这样说着的同时，脸颊也同样是主动搁在了%CALLNAME:MASTER%的胸前
「はっ……ひゃっ、あっ……」	「哈...啊...」
%CALLNAME:MASTER%の射精を受けて、%CALLNAME%は白い喉を逸らせ幼い喘ぎ声を上げる	感受到%CALLNAME:MASTER%的精液被注入体内，%CALLNAME%那稚嫩的喉咙里也不禁发出了淫靡的娇喘声
「すごい……とーさまのせーえき出してもらったんだって思ったら、身体が……」	「好厉害...刚刚被父亲大人的精液射进来，身体就...」
頬を上気させて射精の余韻に浸る%CALLNAME%	沉浸在射精余韵中的%CALLNAME%主动将脸颊向上抬起
既に彼女の膣奥は、射精を快楽として認識できるまでに調教されているようだ	看来她的膣道已经被调教到了能对单纯的被射精这种事情而感到快感的程度了...
「はっ……やっ、奥に、奥に来てて……ひゃうぅっ！」	「哈啊...哈啊，射进来，射到最里面...呜啊啊~~」
%CALLNAME:MASTER%の肉棒を何度も受け入れた膣内は柔らかく解れ、	被%CALLNAME:MASTER%的肉棒反复耕耘着的膣穴主动放松开来
幼子の奥の奥、未だ未成熟な子を宿す器官の入り口さえもが、%CALLNAME:MASTER%を迎え入れようと僅かに口を開いている	在幼女身体的深处，甚至连那用于容纳尚未成熟的婴儿的器官的入口，也在微微张开嘴来欢迎着%CALLNAME:MASTER%
亀頭がドーナツ状の肉を突き押せば、少女の最奥を守る入り口は戸惑いながらも誰が主人かを学びつつある	当龟头推挤内里那甜甜圈形状的肉时，少女最深处的那守护花房的入口，便被强行刻写下了快感的记忆
「と、とーさま。待って……そこ、射精されたら、ほんとに……んんっ～～～！」	「爸...爸爸，等等...如果那里再被射进来的话，真的会...嗯嗯~~~！」
%CALLNAME%の言葉が終わるのを待たずして放たれた白濁液に、幼い肢体が震え、しなやかな足が%CALLNAME:MASTER%に絡めつけられる	还没等%CALLNAME%说完，子种汁就这样被注入了她的子宫中，使得她幼小的身体颤抖起来，纤柔的双脚主动抬起后便缠住了%CALLNAME:MASTER%的腰肢
「はっ……あっ……。とーさま、なんだかすごいところにせーえき出そうとしてない？」	「哈...啊...爸爸，你喜欢这样射进我的里面的感觉吗？」
「もしかしてボク、全然想像できないところまで、とーさまに調教されちゃうのかも……」	「或许啊，我会被你调教到完全无法想象的地步呢...」
「ひゃっ……あっ……ちょっと、そこ、もう奥だか……ら……」	“啊呀...啊...等等，已经插到最深了...啊...”
「もう入らないから、待っ……つっ……っっっ～～～！！」	「已经进不去了，等等...嗯啊~~~！！」
%CALLNAME:MASTER%を受け入れることのみを教え込まれた%CALLNAME%の膣の最奥	%CALLNAME%阴道的最深处，只会因%CALLNAME:MASTER%的肉棒而兴奋
未だ硬さの残る肉輪へと、亀頭を突き入れる	将龟头插入那尚且还残留着兴奋的肉圈之中
幼女のもっとも神聖な場所を守る子宮口は緩みつつも、%CALLNAME:MASTER%の陰茎を半ば受け入れることを拒み	保护着幼女那最神圣的地方的子宫颈逐渐放松开来，但依旧无法接受%CALLNAME:MASTER%阴茎的插入
そうであるがゆえに輪のようになった肉壁が亀頭のくびれを絶妙の力加減で包み込むこととなり、%CALLNAME:MASTER%に未知の快楽を与えてくる	不过正因为如此，变得像肉圈那般的肉壁正以绝妙的力量将龟头包入期间，给予着%CALLNAME:MASTER%未知的快乐
「うそ……そんなところまでとーさまが、とーさまが入って……あっ、はっ……っっっ～～～！」	「嗯啊...骗...骗人的吧，爸爸，竟然插到这里...嗯，哈啊~~~！」
呆然とする%CALLNAME%の”入り口”を占拠したまま放たれた熱液の勢いに、%CALLNAME:MASTER%の眷属は吐精の勢いのみで絶頂を迎える	在呆然的状态下被插入花心后所释放出的炽热精液下，%CALLNAME%以像是要将射入其中的精液挤压出来般的气势猛地迎来了绝顶
「はっ、はっ、はっ……。とーさま、とーさまぁ……」	「哈啊...哈啊...父亲大人...」
常よりも深く密着した腰を離したくないとばかりに%CALLNAME:MASTER%に抱きつきつつ	不愿放开比平常更加贴近的腰，就这般紧紧抱住%CALLNAME:MASTER%的%CALLNAME%
%CALLNAME%は肌を桜色に染め、うわ言のように%CALLNAME:MASTER%の名を呼んでいる	浑身肌肤在兴奋中都染上了樱花般的淡粉色，口里也如在说梦话般不住呼唤着%CALLNAME:MASTER%的名字
「ひぅぅっ……ひゃっ……はっ……」	「唔...啊呀...哈...」
言葉を発する余裕もなく、%CALLNAME:MASTER%の蹂躙に耐える%CALLNAME%	没有说话的余力的%CALLNAME%，只能任由着%CALLNAME:MASTER%的蹂躏
%CALLNAME:MASTER%の眷属の子宮はおずおずと口を開き、輪状の肉でもって%CALLNAME:MASTER%の亀頭を迎え入れる	%CALLNAME:MASTER%女儿的子宫颤抖着张开嘴，用入口处的娇嫩肉圈迎接着%CALLNAME:MASTER%的龟头
「はっ、はっ……とーさま、とーさま……ひゃぅぅぅぅっ！」	「哈啊，哈啊...父亲大人...呜~~~」
本来ならば交わりに用いられる場所でない場所まで開発された%CALLNAME%の内奥	本来不应被用作性交的地方也被开发了的%CALLNAME%
%CALLNAME:MASTER%の陰茎に傅くことを教え込まれた内臓が、	被教导服从%CALLNAME:MASTER%阴茎的，位于体内深处的器官
己の機能を忘れ去り、只々快楽器官として怒張に奉仕し	几乎已是忘记自己的机能，至少此时此刻，是只作为能够感受到快乐的性器来为肉棒做着侍奉
%CALLNAME:MASTER%と、%CALLNAME:MASTER%の子へと異形の快楽を与えていく	%CALLNAME:MASTER%就这般将异常的快乐教给了自己孩子的身体
「あっ……とーさまのが、おくのおくで出て……あはっ、ぁぁぁぁぁ♪」	「啊...爸爸的，在里面出来...哈啊啊~~~♪」
子を成し、育むための器官へと白濁液を直接放たれ、%CALLNAME%は潮を吹きながら絶頂する	将白浊射入那用于诞生与养育孩子的器官中时，%CALLNAME%就在潮吹的同时剧烈地绝顶了
ひくり、ひくりと身を震わせ、細くたおやかな指が何かに縋るように虚空を掻く	在身体抽搐着的同时，那纤细柔软的手指也仿佛是要紧紧地抓住什么似的，在虚空中不住划过
「は、はは……。ボク、イっちゃった。膣内じゃなくて、その奥で」	「啊...哈啊...我...我也去了呢...不是在小穴里，而是在里面的深处...」
「お母さんになるための場所までとーさまの白いので埋め尽くされて……」	「为了成为母亲，里面完全都被父亲大人的精液填满了...」
「凄いよ、とーさま。ボク、どこまでとーさまのものになれるんだろう。体も、心も、身体の内側、内臓だって……」	「好厉害...爸爸。我，不知道自己能够到何种地步的成为父亲大人的东西呢...从身体到心灵...然后是身体的里侧和内脏...」
「……うぅん。怖くなんかないよ。だって、とーさまがしてくれることだもの」	「...嗯，没有害怕哟，毕竟啊...是父亲大人对我做的事情哦」
「このまま体の内側どころか、魂までもとーさまに開発して欲しいな」	「不要说身体的内侧了，就连灵魂也想被父亲大人开发呢」
「とーさまのことだもの。”子宮にせーえき出されてイっちゃう実娘”くらいじゃ、まだ満足できないんでしょ？」	「我相信...仅仅只是在亲生女儿的子宫里射精...爸爸肯定还不满足吧？」
「いいよ、とーさま。もっとボクを調教して」	「好哦，父亲大人，再多调教一下我吧」
「とーさまのおちんちん専用の女の子に、とーさまのせーえきで作られた%CALLNAME%を作り変えて行って……」	「把用爸爸的精液所创造的我，彻底变成爸爸专用的性玩具吧」
「あっ……うっ……とーさま、とーさまぁ……」	「啊...呜...父亲大人，父亲大人...」
僅かな怯えと、それを厚く塗り潰すかのような歓喜を滲ませ、%CALLNAME%は%CALLNAME:MASTER%に抱きつく	%CALLNAME%怀着轻微的恐惧和一丝喜悦抱紧了%CALLNAME:MASTER%，像是贪求着更多宫内射精为自己带来的快感般
実父によって快楽器官へと作り変えられた%CALLNAME%の子宮口はどろりとした淫液を吐き出し、	%此时此刻，即使是CALLNAME%的子宫口也被自己的亲生父亲改造成了能够产生快乐的器官，并从中吐出了粘稠的淫液
只それのみを受け入れるよう躾けられた肉棒へ奉仕しようと口を開く	在曾经所刻写下的调教下1，她的宫颈口不由自主地张了开来，以侍奉着自己亲生父亲的肉棒
「はっ……あっ……とーさまのが、まだ入ってきて……」	「哈...啊...父亲大人的...还在射进来...」
父娘の恥骨が互いの皮膚と肉を介してこつりとぶつかり合い、幼く薄い下腹部がうっすらと陰茎の形の盛り上がりを見せる	父女的耻骨相隔的只有彼此的皮肉，就这般在反复的抽送中不住地碰撞着，纤瘦幼嫩的下腹部此时此刻甚至都显出%CALLNAME:MASTER%肉棒形状的凸起
少女の聖域を守り固く口を塞いでいるはずの肉輪は陰茎の半ばをしごくように締め付け、	原先是为了守护少女那片纯洁圣域的紧闭着的肉口，因探求着快乐而将阴茎的一半都接受其中
己を作り出した精虫を受け入れようと淫らがましく脈動する	为了容纳曾同样创造出自己的精液而淫乱地收缩着
「ふふっ……凄い。ボク、一番大事なところで、とーさまにごほーしできてる……」	「呼呼...好厉害。我...我最重要的地方，让父亲大人舒服起来了...」
「とーさま、こんなところまでボクを開発してくれたんだ。とーさまにごほーしするための女の子にしてくれたんだ」	「已经把我开发到这种程度...哈啊...我现在...肯定是成为了父亲大人喜欢的那种类型的女孩子了吧...」
「ねぇ、とーさま。出して。ボクの、コドモを作る場所に、せーえき頂戴？」	「嗯...爸爸，请射进来吧，射到生孩子的地方...想必爸爸你也很想要吧」
「ボクが確実に、とーさまの子を身ごもれるように。……ううん、それだけじゃないや」	「我想怀上父亲大人的孩子哦...不，不仅如此」
どこか焦点の定まらぬ双眸で%CALLNAME:MASTER%を見上げ、%CALLNAME%は酷く危うげな色気を含んだ声音で言葉を紡ぐ	在某处用飘忽不定的双眸仰望%CALLNAME:MASTER%的%CALLNAME%，用极其危险的语调继续编织着语言
「これからできる、ボクととーさまの子にも、とーさまのおちんちんを教えてあげて」	「今后，也请教育我的孩子关于爸爸肉棒的事情哦」
「ボクの娘に、人の形になる前から。誰にごほーしするために生まれて来るか、何を体に受けることが幸せなのか」	「甚至在我的女儿得到人形降生于世之前。告诉她自己诞生的意义是什么，是为了给谁带来快乐，以及...应该在身体里，接受些什么才能得到快乐」
「ボクがちょーきょーされたよりももっともっと前から、とーさまにごほーしする幸せを教えてあげて欲しいんだ……」	「希望爸爸可以好好地教育她呢，就让她在更早更早以前...就好好体会到我从小到大都浑然不知，直到如今才意识到并享受着的，至高的幸福吧」
「ひゃぅぅっっ、とーさま、とーさまぁ……」	「呜~~父亲大人，父亲大人...」
体格差を考えれば間違いなく不自然に密着した父娘	考虑到巨大的体格差，即使是远远望去这对父女的姿态也绝对是不自然的亲密
既に子を宿す器官で奉仕することに慣れ切った%CALLNAME%の内臓は、%CALLNAME:MASTER%へ更なる献身を果たそうと淫らに蠢いていく	已经习惯了以用于诞生孩子的器官为肉棒服务的%CALLNAME%的内脏，为了完成对%CALLNAME:MASTER%的新的献身而淫乱地收缩着
肉棒の根元を舐る膣、半ばを扱く子宮口。亀頭に突かれる子宮の奥肉さえもが、主の精を欲して纏わりつく	肉棒的根部由膣道做着侍奉，而前端则是深深地插入了子宫口中。就连被龟头深深插着的的子宫的最深处，都因对父亲精液的贪求而与那异物紧紧缠绕在一起
「はっ……あっ、あぁぁっ……えっ、えっ？　……ひうぅぅっ！」	「哈啊...啊...咿~~呜呜...！」
子宮へと直接放たれた白濁液は、愛娘の子宮を満たすだけではとどまらなかった	在最深处释放的白浊，注满了爱女的子宫
子を宿す器官を守るためではなく、ただ一人に奉仕するためだけの淫肉へと化した子宮口が、主人の恩寵を外へ吐き出すわけもなく	此时此刻淫肉化的子宫口，已然不再是单独为了保护寄宿在子宫的孩子的器官，也自然是不可能再将主人的恩宠吐向外面
%CALLNAME%の兄弟姉妹とでもいうべき濁流は、子宮の更に深奥。卵管を通った先へと雪崩れ込む	那些全然能够说是%CALLNAME%兄弟姐妹的浊流，注入了子宫的深处。像是雪崩那般，即使是输卵管也被注满了
子宮どころか卵巣までも%CALLNAME:MASTER%の精液に侵される衝撃に、%CALLNAME%は幼いまま淫らに作り変えられた肢体をひくり、ひくりと震わせる	别说子宫，就连卵巢都被%CALLNAME:MASTER%的精液侵袭，%CALLNAME%在年幼时就被淫乱地改造了的身体，此时此刻正不断地颤抖着
「はぁっ、はぁっ、はぁっ……すごいや、とーさま」	「哈啊...哈啊...好厉害...」
「ボクのなか、全部とーさまのものにされちゃった」	「我身体的一切...都变成父亲大人的东西了...」
「とーさま以外のモノなんて絶対に受け付けない、とーさまにほーしするだけのもの」	「除了父亲大人以外的东西，都是绝对不可能接受的...唯一接受的就只有父亲大人的了哦」
「ううん、ボクだけじゃない。ボクの子供だってそう」	「不，不止是我哦。就算是我的孩子，也要变成这种样子...」
「だって体ができる前から、ただ一つであるよりももっと前から、とーさまの味を覚えてるんだもの」	「因为在我的肉体成型之前更早的时候...我就记得父亲大人的味道了」
「ね、とーさま。ボクを孕ませて。ボクに、とーさまにごほーしする女の子を作らせて」	「呐，爸爸，让我怀孕吧...就这样让我生下一个，此生只为侍奉爸爸而存在的女儿」
「ボクの心も、身体も。今も、未来も、その先も。全部とーさまにあげられるんだって、教え込んで……」	「我要把我的思想，我的身体。我的现在，我的未来，还有我所有的一切...全部都献给父亲大人...」
「あぁぁっっ！　とーさまのが、ボクの奥の奥にまで……」	「嗯啊啊~~就这样射进来吧，直到我的最深处...」
膣内でも、子宮内もなく。その奥までも%CALLNAME:MASTER%の精液に蹂躙され	除却膣道与子宫之外，甚至连最深处都被%CALLNAME:MASTER%的精液蹂躏着
%CALLNAME%は熱病に浮かされたようにつぶやく	轻声呢喃着的%CALLNAME%，好像是发烧了似的
「ふふっ……とーさまとの子、楽しみだなぁ」	「呼呼...和父亲大人生下的孩子...好期待...」
「形になる前からとーさまの精液で犯されて、じゅーりんされて……」	「在成形之前就被父亲大人的精液侵犯，以及浸透...」
「とーさまの性玩具になるためだけに生まれてくる娘……」	「只为成为父亲大人的性玩具而诞生于世的女儿...」
「ねぇ、とーさま。この娘はどんなふうにちょーきょーするの？」	「呐，爸爸，你打算给这个女儿起什么名字呢？」
「実娘の胎内で、とーさまのせーえきで侵されながら形作られるこの娘を」	「父亲大人的精液注入亲生女儿的胎内，而形成的这个女儿」
「どんなヘンタイさんに仕立て上げるの？」	「你想要把她塑造成什么样子呢？」
うっとりと己の下腹部を撫でる%CALLNAME%は、	%CALLNAME%出神地抚摸着自己的小腹
潤んだ瞳で%CALLNAME:MASTER%を見上げ、たまらぬという風に身を震わせている……	同时也用湿润的眼睛仰望着%CALLNAME:MASTER%，她的身体正在拂过体表的微风中不住颤抖...
「んっ……もう、とーさま。子供が出来ちゃったらどうするのさ」	「嗯...爸爸，如果有了孩子的话...那该怎么办呢？」
「子供に君のお父さんは御祖父ちゃんなんだなんてこと、どうやって説明するつもりなの？」	「你要怎么向你的孩子解释，她的父亲还是自己的祖父这种事情？」
「はうぅ……。お尻の中、とーさまので一杯だよ……」	「嗯啊...屁股里面，被父亲大人灌满了...」
「はっ……あっ……あむっ……んちゅっ……」	「哈啊...嗯...」
勢いよく放たれ、自らを白く染める白濁液を、%CALLNAME%は一心不乱に指ですくい取り、舐めあげる	%CALLNAME%专心地舔舐着手指所沾上的白浊液
「んっ……れろっ……ふふっ、ごちそうさま」	「嗯...哈...呼呼，谢谢款待哦♥」
「ね、とーさま。ボクを外から汚しただけで満足だなんて、そんなことは無いよね」	「呐，爸爸。我才不会是那种只是从外面弄脏就满足了的女孩子哦？」
「今度は口から、あそこから、お尻から……身体の内側から、ボクをとーさまの色に染め上げてよ」	「这次从嘴巴，或者屁股开始...把我从身体的内侧，都彻底染上父亲大人的颜色吧」
そう言って%CALLNAME%は幼い相貌を淫靡に歪め、%CALLNAME:MASTER%の胸に顔をうずめた	这样说着的同时，%CALLNAME%的幼齿脸蛋也不禁是露出淫靡的笑，随后就将脸直接埋入了%CALLNAME:MASTER%的胸口
「わっ……あ……もったいないなぁ、もう」	「呜哇...好可惜...」
手に、顔に、胸に。降り注ぐ熱い精液を、%CALLNAME%は避けもせずに受け止める	手掌、脸蛋、胸口...%CALLNAME%毫不逃避地接受那倾注而下的炽热精液
「んっ、ちゅっ……あむっ、れろっ……」	「哈...啊...」
「どうせならさ、口とか、あそことかに出してくれればいいのに。とーさまのが、もったいないよ」	「可是人家想要的明明是被父亲大人射在嘴里或者其他上面地方呢...手上什么的也太浪费了啦」
身体に張り付いた白濁液を指ですくってなめとりつつ、%CALLNAME%は愛らしく頬を膨らませて見せた	%CALLNAME%可爱地鼓起脸颊，同时也用手指尽量沾上射在身上的白浊并缓缓舔去
「ん……。すごい、いっぱい出てる……」	「嗯...好厉害...射出来好多...」
手を、胸を、顔を。勢いよく吐き出された白濁液に汚されながら	手掌、脸蛋、胸口...都被被气势十足地吐出的白浊弄脏了
%CALLNAME%はまじまじと手の中で暴れる陰茎を見つめている	%CALLNAME%目不转睛地注视着手中跳动着的阴茎
「わ、ひゃっ……。もー、出すなら出すと言って欲しかったなぁ」	「哇...啊...姆，要是想射的话就说一声嘛」
%CALLNAME%は不満そうに手についた白濁液を拭っている	%CALLNAME%有些不满地擦拭着手上沾染的精液
「ん……んんっ……つっ～～～」	「嗯...嗯唔~~~」
口腔へと精液が放たれると、%CALLNAME%は感極まったかのように身を震わせる	精液被释放到口腔后，%CALLNAME%浑身便都在激烈地颤抖着，像是即使如此都感受到了快感般
「はっ、はっ、はぁ……。あはは、とーさまの出されてるって思ったら、イっちゃった」	「哈啊...哈啊...哈哈...刚刚感觉到爸爸似乎要射出来的时候...我就跟着高潮了...」
%CALLNAME%は僅かに口元に残った精液をぺろりと舐めると、%CALLNAME:MASTER%のものを清めるべく再び肉棒に舌を這わせ始めた	%CALLNAME%稍微舔了舔嘴角残留的精液，紧接着再次伸出舌头在面前的肉棒上舔舐起来，为%CALLNAME:MASTER%做着清洁口交...
「喉の奥に出されるのって、大好き」	「被插到喉咙里面什么的~最喜欢了」
「とーさまのものがボクのおなかの中を染め上げて、ボクが誰のものなのかを教えてくれるんだ……」	「然后我的肚子里面就会被染上爸爸的颜色...味道和感觉就会提醒我，我是谁的所有物...」
「んっ……あむっ……んん～～～っ」	「嗯...嗯唔~~~」
%CALLNAME:MASTER%の射精が迫ると、%CALLNAME%はその腰を抱き、ぎちぎちに膨張した淫棒を喉奥にまで加えこむ	感觉到%CALLNAME:MASTER%的射精迫近的时候，%CALLNAME%抱紧腰肢的动作便愈发用力，拼命地将膨胀着的肉棒容纳到自己的喉咙深处
限界まで開かれた小さな口が陰茎の根元に触れ、亀頭が口腔の奥の奥、輪のような肉によって締め付けられる	张开到极限的嘴唇触碰到阴茎的根部，而龟头则是被口腔深处那像圈一样的嫩肉紧紧地缠着
「ん……かひゅっ……んっっっっ！」	「嗯...唔...唔唔~~~~！」
口腔ではなく、そのさらに奥で放たれた奔流を、%CALLNAME%は恍惚とした表情で呑みこんでいく	%CALLNAME%带着恍惚的表情咽下了那道在喉咙的深处所释放出的精流
「はっ、はっ、はっ……はぁ……」	「哈啊...哈啊...」
ずるりと抜き出されたペニスを前に。%CALLNAME%は細い身体を震わせ、喉を抑えながらも、潤んだ目で%CALLNAME:MASTER%を見上げている	在被抽出的阴茎面前。%CALLNAME%颤抖着娇小的身体，轻抚着自己喉咙的同时，用湿润的眼睛仰望着%CALLNAME:MASTER%的脸
「苦しかっただろうって？　うん、でもいいんだ」	「不痛吗...？哈啊...有一点哦，但是...没关系啦」
「だって、とーさまをいつもよりも奥の方で受け止められたんだもの」	「因为，比平时更深的地方...接受了父亲大人的精液...」
「ねぇ、とーさま。もっとボクを感じて。ボクの体の、中も外も奥底も。ぜんぶ、ぜんぶとーさまのものだって証明して」	「呐，爸爸，请更多地感受我吧。我身体的里面，外面还有最深处...全部，全部都是父亲大人的东西」
「はっ、あっ……まだ、びゅー、びゅーって出てる……」	「哈...啊...就这样biubiu地射了进来...」
跳ねあがった肉棒に押されるように口を離した%CALLNAME%は、いまだ吐精を続ける%CALLNAME:MASTER%のペニスを、うっとりと見つめている	%CALLNAME%出于迎接肉棒的本能地主动张开嘴来，眼睛也是出神地凝视着仍在射精的%CALLNAME:MASTER%的阴茎
「あはっ……とーさまのあったかいのが、全身にかかって……」	「啊哈...父亲大人的热热的东西，全身都挂在我的身上...」
白く華奢な肢体を、黄ばんだ白で汚された%CALLNAME%は、恍惚とした表情で%CALLNAME:MASTER%の射精を受け止める	浑身都被泛黄的白浊染遍的%CALLNAME%，带着喜悦的表情迎接着%CALLNAME:MASTER%的射精
「ふふっ……とーさまの、凄い臭い……」	「呼呼...爸爸的，好臭呢...」
「いいよ、ボクにマーキングして……」	「好哦，那就...用它来好好地标记我吧」
「どんなに洗ったって落ちないくらい、とーさまのせーえきで染め上げて……」	「用爸爸的精液为我染上不管怎么洗都洗不掉的颜色...」
「いつでも、どこでも、誰でも。ボクがとーさまの物なんだって分かるくらい」	「无论何时何地，任何人都会明白，我是父亲大人的所有物」
「ボクにとーさまのニオイを刷り込んで……」	「所以...在我的身上，留下爸爸你的味道吧...」
「んっ……んぐっ……んっ……んんっ～～～～！！」	「嗯...唔唔...唔~~~~！！」
精液を飲んだことでスイッチが入ったのか。%CALLNAME:MASTER%の血族は絶頂したかのように身を震わせる	因为喝了精液所以触发到上什么开关了吗？%CALLNAME:MASTER%的女儿像是绝顶般颤抖着身体
「はっ、はっ、はっ……。とーさまの、凄いよ……。もうボク、喉でも懷孕しちゃいそう……」	「哈啊...哈啊...爸爸，好厉害...感觉喉咙里都要怀孕了...」
恍惚とした表情で妄言を吐きつつ、%CALLNAME%は未だ尿道口より白濁液を出す陰茎に口づけを落とした	带着恍惚的表情胡言乱语着的%CALLNAME%，主动亲吻着%CALLNAME:MASTER%那马眼中仍在流淌着白浊液的肉棒
「んっ……ごくっ……あっ……んんっ……ぷはっ……」	「嗯...哈啊...啊...」
「すっごい量……なんだか、おなかの中までとーさまに犯されてるみたい……」	「射出来了好多...感觉肚子里都好像被爸爸侵犯了...」
「え？　ううん、嫌じゃないよ。とーさまのが口に出されるとね」	「诶？才，才没有讨厌哦？」
「腰の奥がずんっってなって、背骨の中にびりって電気が走るの」	「每次爸爸说话的时候，我的里面都会感觉像是触电一样...」
「あむっ……れろっ……だから……もっとせーえき、ちょうだい？」	「啊...啊呀，所以...再多给我一点好吗？」
「僕の中も外も、とーさまのでいっぱいにして……」	「我的里面和外面，都要把爸爸的精液装得满满的...」
「ん……んっ……ごくっ…………あ、そっか。まだ残ってるよね、ちゅっ……んっ」	「嗯嗯...啾...是...是这样啊。还残留着一些呢，啾...嗯...」
%CALLNAME%は口に出されたものを飲み込むと、再び%CALLNAME:MASTER%のものに口をつけ、尿道に残った精液を吸いだした	%CALLNAME%主动吞下了射入口中的精液，随后便再次含上了%CALLNAME:MASTER%的肉棒，吸出了残留在尿道中的剩余白浊
「はひゃっ……とーさまの、まだどくどくいってて……ちゅっ……んむっ……」	「哈啊...爸爸的肉棒，还在一跳一跳的...嗯...唔...」
そう言って%CALLNAME%は、吐精の終わらぬ肉棒に吸い付き、吸い上げる	这么说着，%CALLNAME%又再度舔上了方才射过精的肉棒，并用力地吮吸起来
「あははっ……とーさまの、びくびくしてて……うん、もっと、もっとボクが気持ちよくしてあげる……」	「啊哈哈...爸爸的肉棒还很兴奋呢...呼呼...我会让爸爸更加舒服起来的哟...」
「とーさまのだからかな。あったかいのがびゅーって出されると」	「可能因为是爸爸的原因吧，每次热热的从里面出来的时候」
「なんだか美味しいきがするよ」	「总会感觉它们很好吃哟」
「んっ、んっ……ごくっ、んむっ……」	「嗯，嗯...好厉害，唔...」
「ふふっ……ヘンな味だけど、とーさまのだと思うと、なんだか美味しい気がするよ……」	「呼呼...虽然是很奇怪的味道，但一想到是父亲大人的...就会觉得很好吃呢...」
「んっ……とーさまのでも、ちょっと苦いかな」	「嗯...感觉爸爸的精液有点苦呢...」
「う……げほ、げほっ……」	「嗯...呜唔，咕唔...」
「ごめん、とーさま。まだ飲んでは上げられないみたい……」	「对不起呢，父亲大人。好像还没喝完...」
「ん……げほっ、げほっ……」	「嗯...唔唔...」
「とーさま。さすがに口の中で出すのはやめて欲しいよ」	「爸爸，希望下次不要再到嘴里射出来了...」
「ひゃっ……わっ……」	「啊...唔...」
「もー、とーさま。出すなら出すって言ってよ」	「啊...爸爸，想射的话就射吧」
このベトベト、落とすの大変なんだから……	这种粘稠的液体很难从身上去除...
そう続ける%CALLNAME%は、不満そうに糸を引く白濁液を指で弄んでいる	这样说着的%CALLNAME%用手指不满地玩弄着拉成道道线条的白浊液
「ふわっ……ひゃっ……あはっ、とーさまのせーえきだぁ♪」	「呼哇...呀...啊哈，是父亲大人的精液呀♪」
肉棒から迸る精液を避けようともせず胸に、顔に浴び、%CALLNAME%は惚けたように笑みを浮かべた	任肉棒将精液射在胸部与脸上，%CALLNAME%像是迷恋般的浮现出幸福的笑容
「ん、勿体無い。いってくえれば、ずちゅっ……んっ……口えも、のどでも受け止めたのに……」	「嗯，太浪费啦...总而言之，如果爸爸告诉我要射了的话...呜嗯...我就会好好地用嘴来接住的...」
肌に飛び散った白濁を丁寧に指で掬い取り、うっとりとした表情で舐めとっていく	%CALLNAME%用手指细致地沾上飞散在体表的白浊，挂着恍惚出神的表情将其缓缓舔去
その頬は極上の酒でも口にしたかのように桜色に染まり、精をすべて舐め取ってなお名残惜しそうに	她的脸颊仿佛尝到了最好的酒般，染上了樱花般的粉红，将精液全部舔去后还在那里仔细嗅闻一番，像是生怕有所遗漏那般
自らの手を舐めている……	将精液全部舔去后还在手上嗅闻了一番，像是生怕有所遗漏那般的，又低下头去再度舔舐起来...
「ね、とーさま。今度は飲ませてね。口も、喉も、体の中も。とーさまので染め上げてほしいな……」	「呐，爸爸，下次就让我好好喝下它们吧。嘴巴，喉咙还有身体里面...想要被染上爸爸的颜色呢...」
「熱い……それにどろっとしてて……んっ、ちゅっ……ヘンな味」	「好热...还有好粘...味道怪怪的...」
%CALLNAME%は胸のみならず顔にまで飛び散った精液を指で掬い取り、僅かに音を立てて舐めとっている	%CALLNAME%将飞散到脸上的精液刮到手指上，仅发出细微声音地舔着
「んっ……わっ、すごい。べとべとだぁ」	「嗯啊...好厉害...黏黏的...」
「よかった。とーさま、ボクで気持ち良くなってくれてるんだね」	「太棒了...父亲大人，我们都...舒服起来了呢」
「”どらいおーがずむ”ってやつ？」	「欸...「干性高潮」是指什么呢？」
「ね、とーさま。それってどんなふうに気持ちがいいの？」	「呐，爸爸。那是什么样的一种感觉呢？」
「ふふっ、とーさま。気持ちよくなってくれたんだ」	「呼呼...爸爸，舒服起来了呢」
「嬉しいな、おちんちん以外でも」	「好开心啊...」
「とーさまをぜっちょーさせられるなんて」	「竟然会让爸爸的鸡鸡这么兴奋呢...」
「娘冥利に尽きるじゃない」	「作为女儿...我感到真幸福呢」
「ご・ち・そ・う・さ・ま。とーさまの、美味しかったよ…♪」	「多·谢·款·待~爸爸的精液...很美味哦♪」
「む～、ボクじゃ役不足なの？　とーさまの白いの、飲みたかったなぁ……」	「嗯姆...是我的侍奉还不够嘛~？父亲大人的精液...好想喝呀...」
「えへへ…はい、これでキレイになったよ？　ふぁぁ…この手巾、とーさまのニオイでいっぱい……」	「欸嘿嘿...是呢，那么现在就干净了吧~？啊啊...这块手巾上，都已经沾满了爸爸的气味了...♥」
「さて、もう一度…いっただきま～す♪　んっ…とーさまの味が、口中に広がって……しゃ～わせ～～♪」	「那么现在...可以再来一次嘛~♪嗯...父亲大人的味道，在我的嘴里蔓延着...好开心♪」
「とーさまの白いタレがかかれば、もっと美味しくなると思うんだけどな～～ねぇ、とーさま？」	「要是沾上父亲大人的白酱的话，就会变得更加美味了呀~~呐，是这样吧~爸爸？」
「う～ん、れーせいに考えたら分かることだけど…とーさまの味しかしないや」	「嗯...不过仔细想想也就还是明白了呐...真的这么做了的话，就只有父亲大人的味道了呀」
（でも、これはこれで…アリかも？　や～ん、ボクってば変態～～♪）	（但是，就算是这样...说不定也不错...是啊~我是个变态呢~~♪）
「んぐ、んぐ、んぐ…はぁ。とーさま、おいしいよぉ……」	「嗯嗯...唔...哈啊~父亲大人，很美味哦...♥」
「む～、可愛い愛娘のおねだりを聞くのは父親の役目じゃないの～？　ほら、おかわりちょーだいよ～」	「姆~溺爱可爱的女儿什么的不是作为父亲应尽的义务吗~？来，就这样再来一次吧~♥」
「えへへ…なんだろ、これ。口の中で味が混ざる……うん、イヤじゃない。イヤじゃないよ？」	「嘿嘿...这是什么呀~？口中夹杂着这种味道...姆~不过，不讨厌哦~」
「え、ちょ、これを飲み干せって……本気？　うぅ、わかったよぉ……」	「欸...要好好地喝完吗~？嗯...我明白啦...」
（えへへ、褒められちゃった♪　どうしよう、嬉しくて濡れてきちゃうよぉ♪）	（欸嘿嘿...被父亲大人表扬啦♪怎么办呢~开心到下面都要湿透了♥）
「あはっ……髪の毛まで、とーさまので犯されちゃってる」	「啊哈...就连头发，都被父亲大人侵犯了」
「ボク、順調にとーさまのモノになれてるよね？　とーさま専用のヘンタイさんになれてるよね？」	「我，能顺利地变成父亲大人的东西吧？变成父亲大人专用的变态桑~」
「あっ…とーさまのニオイ、髪の毛に刷り込まれちゃった……♪」	「啊...父亲大人的气味，被印在头发上了...♪」
「ニオイだけで、ボクがとーさまのモノだってわかっちゃう…父親のチンポ臭振りまく便器娘だってバレちゃう…♪」	「只要有气味，我是父亲大人的所有物这一事实就会在我的心里被强调...~而爸爸也是呢~只要闻到我的气味，就会知道来人是父亲大人的肉便器女儿哟~♥」
「とーさまの味で、赤ちゃん喜んでるよぉ…この子もきっと、とーさまのミルク大好きになるよね…？」	「呼呼...爸爸的味道，就要这样成为小宝宝的养分了哟~？这个孩子也一定会变得非常喜欢爸爸的牛奶的吧~♥」
「えへへ、白いのイッパイ飲んだから、きっとボクも白いのイッパイ出せるよ？」	「欸嘿嘿...享受着父亲大人精液里的养分，孩子也一定会很开心的吧~？」
「ねぇ、とーさま？　かわいい孫のために母乳の出をよくするのも父親のギムじゃないかな？かな？」	「呐，爸爸~为了可爱的孙女好好地射出白色的液体给她们补充养分也是父亲的职责呢~对吧？」
「うん、ボクはとーさまのミルク好きだけどさ。この子がボクのよりとーさまのミルク飲みたがったらどうしよう……」	「是这样呢...我喜欢父亲大人的牛奶。可是如果孩子要是比我更加想喝的话那又该怎么办呢...」
「え、お腹の子の栄養……？　とーさま、それはボクでもさすがにどーかと思うよ？」	「欸...作为肚子里孩子的营养吗？嗯...爸爸，连我都觉得有些奇怪了呢」
